timestamp,weather,tem,weekday,holiday,dor,teab,cnt
2023/2/1 0:00,1,10,1,0,3,0,3
2023/2/1 0:10,1,10,1,0,3,2,5
2023/2/1 0:20,1,10,1,0,4,3,7
2023/2/1 0:30,1,10,1,0,2,1,3
2023/2/1 0:40,1,10,1,0,1,1,2
2023/2/1 0:50,1,10,1,0,1,0,1
2023/2/1 1:00,1,9,1,0,1,2,3
2023/2/1 1:10,1,9,1,0,0,1,1
2023/2/1 1:20,1,9,1,0,0,0,0
2023/2/1 1:30,1,9,1,0,0,2,2
2023/2/1 1:40,1,9,1,0,0,1,1
2023/2/1 1:50,1,9,1,0,2,2,4
2023/2/1 2:00,1,9,1,0,1,2,3
2023/2/1 2:10,1,9,1,0,2,1,3
2023/2/1 2:20,1,9,1,0,1,0,1
2023/2/1 2:30,1,9,1,0,1,0,1
2023/2/1 2:40,1,9,1,0,1,0,1
2023/2/1 2:50,1,9,1,0,2,0,2
2023/2/1 3:00,1,9,1,0,2,1,3
2023/2/1 3:10,1,9,1,0,2,0,2
2023/2/1 3:20,1,9,1,0,2,2,4
2023/2/1 3:30,1,9,1,0,1,1,2
2023/2/1 3:40,1,8,1,0,2,1,3
2023/2/1 3:50,1,8,1,0,0,2,2
2023/2/1 4:00,1,8,1,0,1,2,3
2023/2/1 4:10,1,8,1,0,0,1,1
2023/2/1 4:20,1,8,1,0,0,1,1
2023/2/1 4:30,1,8,1,0,1,2,3
2023/2/1 4:40,1,8,1,0,0,2,2
2023/2/1 4:50,1,8,1,0,2,2,4
2023/2/1 5:00,1,8,1,0,1,1,2
2023/2/1 5:10,1,9,1,0,1,1,2
2023/2/1 5:20,1,9,1,0,2,2,4
2023/2/1 5:30,1,9,1,0,3,2,5
2023/2/1 5:40,1,9,1,0,2,0,2
2023/2/1 5:50,1,9,1,0,4,0,4
2023/2/1 6:00,1,9,1,0,4,2,6
2023/2/1 6:10,1,9,1,0,3,1,4
2023/2/1 6:20,1,9,1,0,5,2,7
2023/2/1 6:30,1,9,1,0,4,4,8
2023/2/1 6:40,1,9,1,0,14,0,14
2023/2/1 6:50,1,9,1,0,34,0,34
2023/2/1 7:00,1,9,1,0,57,4,61
2023/2/1 7:10,1,9,1,0,101,2,103
2023/2/1 7:20,1,9,1,0,109,1,110
2023/2/1 7:30,1,10,1,0,304,1,305
2023/2/1 7:40,1,10,1,0,534,5,539
2023/2/1 7:50,1,10,1,0,623,5,628
2023/2/1 8:00,1,10,1,0,313,6,319
2023/2/1 8:10,1,10,1,0,127,8,135
2023/2/1 8:20,1,10,1,0,84,9,93
2023/2/1 8:30,1,10,1,0,92,14,106
2023/2/1 8:40,1,10,1,0,71,14,85
2023/2/1 8:50,1,10,1,0,84,13,97
2023/2/1 9:00,1,10,1,0,90,13,103
2023/2/1 9:10,1,10,1,0,75,17,92
2023/2/1 9:20,1,10,1,0,172,26,198
2023/2/1 9:30,1,11,1,0,243,42,285
2023/2/1 9:40,1,11,1,0,247,131,378
2023/2/1 9:50,1,11,1,0,173,151,324
2023/2/1 10:00,1,11,1,0,143,169,312
2023/2/1 10:10,1,11,1,0,85,101,186
2023/2/1 10:20,1,11,1,0,67,80,147
2023/2/1 10:30,1,11,1,0,68,53,121
2023/2/1 10:40,1,11,1,0,61,40,101
2023/2/1 10:50,1,12,1,0,66,37,103
2023/2/1 11:00,1,12,1,0,61,39,100
2023/2/1 11:10,1,12,1,0,56,40,96
2023/2/1 11:20,1,12,1,0,58,47,105
2023/2/1 11:30,1,12,1,0,62,70,132
2023/2/1 11:40,1,12,1,0,77,225,302
2023/2/1 11:50,1,12,1,0,69,287,356
2023/2/1 12:00,1,13,1,0,52,242,294
2023/2/1 12:10,1,13,1,0,61,174,235
2023/2/1 12:20,1,13,1,0,63,128,191
2023/2/1 12:30,1,13,1,0,38,84,122
2023/2/1 12:40,1,13,1,0,29,69,98
2023/2/1 12:50,1,13,1,0,20,50,70
2023/2/1 13:00,1,13,1,0,16,34,50
2023/2/1 13:10,1,13,1,0,11,20,31
2023/2/1 13:20,1,13,1,0,16,16,32
2023/2/1 13:30,1,13,1,0,21,17,38
2023/2/1 13:40,1,13,1,0,34,23,57
2023/2/1 13:50,1,13,1,0,27,24,51
2023/2/1 14:00,1,13,1,0,31,25,56
2023/2/1 14:10,1,13,1,0,22,22,44
2023/2/1 14:20,1,13,1,0,18,20,38
2023/2/1 14:30,1,13,1,0,18,22,40
2023/2/1 14:40,1,13,1,0,17,17,34
2023/2/1 14:50,1,13,1,0,19,15,34
2023/2/1 15:00,1,12,1,0,24,14,38
2023/2/1 15:10,1,12,1,0,32,17,49
2023/2/1 15:20,1,12,1,0,27,19,46
2023/2/1 15:30,1,12,1,0,30,18,48
2023/2/1 15:40,1,12,1,0,31,22,53
2023/2/1 15:50,1,12,1,0,29,18,47
2023/2/1 16:00,1,12,1,0,32,20,52
2023/2/1 16:10,1,12,1,0,26,18,44
2023/2/1 16:20,1,12,1,0,30,18,48
2023/2/1 16:30,1,12,1,0,37,13,50
2023/2/1 16:40,1,12,1,0,33,14,47
2023/2/1 16:50,1,11,1,0,41,18,59
2023/2/1 17:00,1,11,1,0,46,23,69
2023/2/1 17:10,1,11,1,0,37,22,59
2023/2/1 17:20,1,11,1,0,42,27,69
2023/2/1 17:30,1,11,1,0,38,30,68
2023/2/1 17:40,1,11,1,0,43,34,77
2023/2/1 17:50,1,10,1,0,49,43,92
2023/2/1 18:00,1,10,1,0,55,38,93
2023/2/1 18:10,1,10,1,0,58,36,94
2023/2/1 18:20,1,10,1,0,56,28,84
2023/2/1 18:30,1,10,1,0,46,36,82
2023/2/1 18:40,1,10,1,0,50,26,76
2023/2/1 18:50,1,9,1,0,50,33,83
2023/2/1 19:00,1,9,1,0,39,25,64
2023/2/1 19:10,1,9,1,0,34,24,58
2023/2/1 19:20,1,9,1,0,30,20,50
2023/2/1 19:30,1,9,1,0,31,25,56
2023/2/1 19:40,1,9,1,0,26,25,51
2023/2/1 19:50,1,9,1,0,27,20,47
2023/2/1 20:00,1,9,1,0,26,23,49
2023/2/1 20:10,1,9,1,0,20,24,44
2023/2/1 20:20,1,8,1,0,19,29,48
2023/2/1 20:30,1,8,1,0,20,37,57
2023/2/1 20:40,1,8,1,0,19,32,51
2023/2/1 20:50,1,8,1,0,17,38,55
2023/2/1 21:00,1,8,1,0,13,40,53
2023/2/1 21:10,1,8,1,0,15,35,50
2023/2/1 21:20,1,8,1,0,15,30,45
2023/2/1 21:30,1,8,1,0,10,29,39
2023/2/1 21:40,1,7,1,0,10,47,57
2023/2/1 21:50,1,7,1,0,10,45,55
2023/2/1 22:00,1,7,1,0,7,47,54
2023/2/1 22:10,1,7,1,0,3,44,47
2023/2/1 22:20,1,7,1,0,2,33,35
2023/2/1 22:30,1,7,1,0,2,21,23
2023/2/1 22:40,1,7,1,0,1,15,16
2023/2/1 22:50,1,7,1,0,2,13,15
2023/2/1 23:00,1,6,1,0,1,7,8
2023/2/1 23:10,1,6,1,0,1,6,7
2023/2/1 23:20,1,6,1,0,1,2,3
2023/2/1 23:30,1,6,1,0,2,2,4
2023/2/1 23:40,1,6,1,0,1,2,3
2023/2/1 23:50,1,6,1,0,2,0,2
2023/2/2 0:00,1,6,1,0,4,1,5
2023/2/2 0:10,1,6,1,0,3,2,5
2023/2/2 0:20,1,6,1,0,4,3,7
2023/2/2 0:30,1,6,1,0,2,0,2
2023/2/2 0:40,1,6,1,0,1,2,3
2023/2/2 0:50,1,5,1,0,0,1,1
2023/2/2 1:00,1,5,1,0,1,1,2
2023/2/2 1:10,1,5,1,0,2,2,4
2023/2/2 1:20,1,5,1,0,1,0,1
2023/2/2 1:30,1,5,1,0,0,2,2
2023/2/2 1:40,1,5,1,0,2,2,4
2023/2/2 1:50,1,5,1,0,0,0,0
2023/2/2 2:00,1,5,1,0,0,1,1
2023/2/2 2:10,1,5,1,0,0,1,1
2023/2/2 2:20,1,5,1,0,1,0,1
2023/2/2 2:30,1,5,1,0,0,1,1
2023/2/2 2:40,1,5,1,0,1,0,1
2023/2/2 2:50,1,5,1,0,0,1,1
2023/2/2 3:00,1,5,1,0,1,1,2
2023/2/2 3:10,1,5,1,0,1,1,2
2023/2/2 3:20,1,4,1,0,0,2,2
2023/2/2 3:30,1,4,1,0,0,2,2
2023/2/2 3:40,1,4,1,0,1,2,3
2023/2/2 3:50,1,4,1,0,0,0,0
2023/2/2 4:00,1,4,1,0,0,1,1
2023/2/2 4:10,1,4,1,0,2,1,3
2023/2/2 4:20,1,4,1,0,1,1,2
2023/2/2 4:30,1,4,1,0,0,1,1
2023/2/2 4:40,1,4,1,0,2,1,3
2023/2/2 4:50,1,4,1,0,2,1,3
2023/2/2 5:00,1,4,1,0,2,1,3
2023/2/2 5:10,1,4,1,0,0,2,2
2023/2/2 5:20,1,4,1,0,2,0,2
2023/2/2 5:30,1,4,1,0,2,0,2
2023/2/2 5:40,1,4,1,0,1,1,2
2023/2/2 5:50,1,4,1,0,4,2,6
2023/2/2 6:00,1,4,1,0,2,2,4
2023/2/2 6:10,1,4,1,0,3,1,4
2023/2/2 6:20,1,4,1,0,4,1,5
2023/2/2 6:30,1,4,1,0,6,2,8
2023/2/2 6:40,1,4,1,0,10,0,10
2023/2/2 6:50,1,4,1,0,35,1,36
2023/2/2 7:00,1,5,1,0,63,3,66
2023/2/2 7:10,1,5,1,0,88,1,89
2023/2/2 7:20,1,5,1,0,115,1,116
2023/2/2 7:30,1,5,1,0,286,2,288
2023/2/2 7:40,1,5,1,0,615,4,619
2023/2/2 7:50,1,5,1,0,564,5,569
2023/2/2 8:00,1,5,1,0,270,7,277
2023/2/2 8:10,1,5,1,0,132,12,144
2023/2/2 8:20,1,5,1,0,105,9,114
2023/2/2 8:30,1,5,1,0,85,12,97
2023/2/2 8:40,1,5,1,0,81,14,95
2023/2/2 8:50,1,5,1,0,71,12,83
2023/2/2 9:00,1,5,1,0,84,16,100
2023/2/2 9:10,1,5,1,0,86,16,102
2023/2/2 9:20,1,5,1,0,170,28,198
2023/2/2 9:30,1,5,1,0,229,45,274
2023/2/2 9:40,1,5,1,0,284,128,412
2023/2/2 9:50,1,5,1,0,200,192,392
2023/2/2 10:00,1,5,1,0,119,165,284
2023/2/2 10:10,1,5,1,0,81,109,190
2023/2/2 10:20,1,5,1,0,69,72,141
2023/2/2 10:30,1,6,1,0,63,56,119
2023/2/2 10:40,1,6,1,0,61,41,102
2023/2/2 10:50,1,6,1,0,63,45,108
2023/2/2 11:00,1,6,1,0,73,43,116
2023/2/2 11:10,1,6,1,0,56,38,94
2023/2/2 11:20,1,6,1,0,60,42,102
2023/2/2 11:30,1,6,1,0,60,77,137
2023/2/2 11:40,1,6,1,0,68,242,310
2023/2/2 11:50,1,6,1,0,67,265,332
2023/2/2 12:00,1,6,1,0,65,250,315
2023/2/2 12:10,1,6,1,0,50,190,240
2023/2/2 12:20,1,7,1,0,62,127,189
2023/2/2 12:30,1,7,1,0,63,93,156
2023/2/2 12:40,1,7,1,0,65,71,136
2023/2/2 12:50,1,7,1,0,54,47,101
2023/2/2 13:00,1,7,1,0,61,27,88
2023/2/2 13:10,1,7,1,0,58,37,95
2023/2/2 13:20,1,7,1,0,94,34,128
2023/2/2 13:30,1,7,1,0,154,37,191
2023/2/2 13:40,1,7,1,0,260,31,291
2023/2/2 13:50,1,7,1,0,222,37,259
2023/2/2 14:00,1,7,1,0,114,29,143
2023/2/2 14:10,1,7,1,0,114,35,149
2023/2/2 14:20,1,7,1,0,106,43,149
2023/2/2 14:30,1,7,1,0,80,47,127
2023/2/2 14:40,1,7,1,0,75,42,117
2023/2/2 14:50,1,7,1,0,66,42,108
2023/2/2 15:00,1,7,1,0,73,39,112
2023/2/2 15:10,1,7,1,0,75,36,111
2023/2/2 15:20,1,7,1,0,86,46,132
2023/2/2 15:30,1,7,1,0,84,74,158
2023/2/2 15:40,1,7,1,0,129,184,313
2023/2/2 15:50,1,7,1,0,153,245,398
2023/2/2 16:00,1,7,1,0,118,148,266
2023/2/2 16:10,1,7,1,0,94,104,198
2023/2/2 16:20,1,7,1,0,74,72,146
2023/2/2 16:30,1,7,1,0,67,61,128
2023/2/2 16:40,1,7,1,0,70,52,122
2023/2/2 16:50,1,7,1,0,81,63,144
2023/2/2 17:00,1,7,1,0,73,63,136
2023/2/2 17:10,1,6,1,0,68,52,120
2023/2/2 17:20,1,6,1,0,69,51,120
2023/2/2 17:30,1,6,1,0,82,76,158
2023/2/2 17:40,1,6,1,0,91,237,328
2023/2/2 17:50,1,6,1,0,84,241,325
2023/2/2 18:00,1,6,1,0,82,222,304
2023/2/2 18:10,1,6,1,0,77,153,230
2023/2/2 18:20,1,6,1,0,82,102,184
2023/2/2 18:30,1,6,1,0,107,81,188
2023/2/2 18:40,1,6,1,0,175,69,244
2023/2/2 18:50,1,6,1,0,168,68,236
2023/2/2 19:00,1,6,1,0,119,60,179
2023/2/2 19:10,1,6,1,0,109,56,165
2023/2/2 19:20,1,6,1,0,94,67,161
2023/2/2 19:30,1,6,1,0,91,55,146
2023/2/2 19:40,1,6,1,0,96,57,153
2023/2/2 19:50,1,5,1,0,78,65,143
2023/2/2 20:00,1,5,1,0,88,66,154
2023/2/2 20:10,1,5,1,0,82,62,144
2023/2/2 20:20,1,5,1,0,75,57,132
2023/2/2 20:30,1,5,1,0,66,93,159
2023/2/2 20:40,1,5,1,0,62,178,240
2023/2/2 20:50,1,5,1,0,51,265,316
2023/2/2 21:00,1,5,1,0,44,158,202
2023/2/2 21:10,1,5,1,0,56,143,199
2023/2/2 21:20,1,5,1,0,33,103,136
2023/2/2 21:30,1,5,1,0,25,62,87
2023/2/2 21:40,1,5,1,0,17,66,83
2023/2/2 21:50,1,5,1,0,16,87,103
2023/2/2 22:00,1,5,1,0,18,76,94
2023/2/2 22:10,1,5,1,0,15,83,98
2023/2/2 22:20,1,5,1,0,14,50,64
2023/2/2 22:30,1,5,1,0,15,38,53
2023/2/2 22:40,1,5,1,0,12,20,32
2023/2/2 22:50,1,5,1,0,10,14,24
2023/2/2 23:00,1,4,1,0,8,10,18
2023/2/2 23:10,1,4,1,0,5,12,17
2023/2/2 23:20,1,4,1,0,7,9,16
2023/2/2 23:30,1,4,1,0,1,9,10
2023/2/2 23:40,1,4,1,0,2,10,12
2023/2/2 23:50,1,4,1,0,2,3,5
2023/2/3 0:00,1,4,1,0,3,1,4
2023/2/3 0:10,1,4,1,0,4,1,5
2023/2/3 0:20,1,4,1,0,2,2,4
2023/2/3 0:30,1,4,1,0,2,0,2
2023/2/3 0:40,1,4,1,0,2,2,4
2023/2/3 0:50,1,4,1,0,2,1,3
2023/2/3 1:00,1,4,1,0,2,1,3
2023/2/3 1:10,1,4,1,0,2,2,4
2023/2/3 1:20,1,4,1,0,0,0,0
2023/2/3 1:30,1,3,1,0,2,1,3
2023/2/3 1:40,1,3,1,0,1,2,3
2023/2/3 1:50,1,3,1,0,1,2,3
2023/2/3 2:00,1,3,1,0,2,1,3
2023/2/3 2:10,1,3,1,0,0,0,0
2023/2/3 2:20,1,3,1,0,1,0,1
2023/2/3 2:30,1,3,1,0,1,2,3
2023/2/3 2:40,1,3,1,0,1,0,1
2023/2/3 2:50,1,3,1,0,2,0,2
2023/2/3 3:00,1,3,1,0,2,0,2
2023/2/3 3:10,1,3,1,0,2,1,3
2023/2/3 3:20,1,3,1,0,2,2,4
2023/2/3 3:30,1,3,1,0,0,1,1
2023/2/3 3:40,1,3,1,0,2,1,3
2023/2/3 3:50,1,3,1,0,1,1,2
2023/2/3 4:00,1,3,1,0,2,2,4
2023/2/3 4:10,1,3,1,0,2,1,3
2023/2/3 4:20,1,3,1,0,0,1,1
2023/2/3 4:30,1,3,1,0,0,1,1
2023/2/3 4:40,1,3,1,0,2,1,3
2023/2/3 4:50,1,3,1,0,0,0,0
2023/2/3 5:00,1,3,1,0,1,0,1
2023/2/3 5:10,1,3,1,0,1,0,1
2023/2/3 5:20,1,3,1,0,0,1,1
2023/2/3 5:30,1,3,1,0,2,0,2
2023/2/3 5:40,1,3,1,0,0,2,2
2023/2/3 5:50,1,3,1,0,3,1,4
2023/2/3 6:00,1,3,1,0,2,2,4
2023/2/3 6:10,1,3,1,0,2,3,5
2023/2/3 6:20,1,3,1,0,5,1,6
2023/2/3 6:30,1,3,1,0,4,4,8
2023/2/3 6:40,1,3,1,0,12,1,13
2023/2/3 6:50,1,3,1,0,35,1,36
2023/2/3 7:00,1,3,1,0,68,3,71
2023/2/3 7:10,1,3,1,0,94,1,95
2023/2/3 7:20,1,3,1,0,119,2,121
2023/2/3 7:30,1,3,1,0,338,2,340
2023/2/3 7:40,1,3,1,0,548,5,553
2023/2/3 7:50,1,3,1,0,615,5,620
2023/2/3 8:00,1,3,1,0,314,8,322
2023/2/3 8:10,1,3,1,0,146,10,156
2023/2/3 8:20,1,3,1,0,101,8,109
2023/2/3 8:30,1,3,1,0,85,15,100
2023/2/3 8:40,1,3,1,0,84,15,99
2023/2/3 8:50,1,3,1,0,82,13,95
2023/2/3 9:00,1,3,1,0,87,17,104
2023/2/3 9:10,1,3,1,0,78,20,98
2023/2/3 9:20,1,3,1,0,153,27,180
2023/2/3 9:30,1,3,1,0,241,38,279
2023/2/3 9:40,1,3,1,0,278,114,392
2023/2/3 9:50,1,3,1,0,201,192,393
2023/2/3 10:00,1,3,1,0,125,139,264
2023/2/3 10:10,1,3,1,0,86,100,186
2023/2/3 10:20,1,3,1,0,86,70,156
2023/2/3 10:30,1,3,1,0,59,51,110
2023/2/3 10:40,1,3,1,0,58,50,108
2023/2/3 10:50,1,3,1,0,77,37,114
2023/2/3 11:00,1,4,1,0,60,42,102
2023/2/3 11:10,1,4,1,0,58,43,101
2023/2/3 11:20,1,4,1,0,68,49,117
2023/2/3 11:30,1,4,1,0,69,68,137
2023/2/3 11:40,1,4,1,0,73,234,307
2023/2/3 11:50,1,4,1,0,59,307,366
2023/2/3 12:00,1,4,1,0,65,269,334
2023/2/3 12:10,1,4,1,0,57,175,232
2023/2/3 12:20,1,4,1,0,53,109,162
2023/2/3 12:30,1,4,1,0,55,87,142
2023/2/3 12:40,1,4,1,0,66,71,137
2023/2/3 12:50,1,4,1,0,65,56,121
2023/2/3 13:00,1,4,1,0,65,31,96
2023/2/3 13:10,1,4,1,0,61,29,90
2023/2/3 13:20,1,4,1,0,95,30,125
2023/2/3 13:30,1,4,1,0,147,30,177
2023/2/3 13:40,1,4,1,0,254,40,294
2023/2/3 13:50,1,4,1,0,264,42,306
2023/2/3 14:00,1,4,1,0,118,28,146
2023/2/3 14:10,1,4,1,0,98,39,137
2023/2/3 14:20,1,4,1,0,99,43,142
2023/2/3 14:30,1,4,1,0,88,44,132
2023/2/3 14:40,1,4,1,0,70,43,113
2023/2/3 14:50,1,4,1,0,66,46,112
2023/2/3 15:00,1,4,1,0,69,46,115
2023/2/3 15:10,1,4,1,0,71,44,115
2023/2/3 15:20,1,4,1,0,81,38,119
2023/2/3 15:30,1,4,1,0,85,69,154
2023/2/3 15:40,1,4,1,0,148,150,298
2023/2/3 15:50,1,4,1,0,151,209,360
2023/2/3 16:00,1,4,1,0,96,148,244
2023/2/3 16:10,1,4,1,0,100,131,231
2023/2/3 16:20,1,4,1,0,73,70,143
2023/2/3 16:30,1,4,1,0,75,60,135
2023/2/3 16:40,1,4,1,0,67,52,119
2023/2/3 16:50,1,4,1,0,66,63,129
2023/2/3 17:00,1,4,1,0,72,59,131
2023/2/3 17:10,1,4,1,0,63,62,125
2023/2/3 17:20,1,4,1,0,79,55,134
2023/2/3 17:30,1,4,1,0,71,83,154
2023/2/3 17:40,1,4,1,0,93,224,317
2023/2/3 17:50,1,4,1,0,97,251,348
2023/2/3 18:00,1,4,1,0,95,223,318
2023/2/3 18:10,1,4,1,0,77,158,235
2023/2/3 18:20,1,4,1,0,90,97,187
2023/2/3 18:30,1,4,1,0,106,81,187
2023/2/3 18:40,1,4,1,0,184,77,261
2023/2/3 18:50,1,4,1,0,183,61,244
2023/2/3 19:00,1,4,1,0,138,59,197
2023/2/3 19:10,1,4,1,0,113,65,178
2023/2/3 19:20,1,4,1,0,96,58,154
2023/2/3 19:30,1,4,1,0,85,65,150
2023/2/3 19:40,1,4,1,0,94,61,155
2023/2/3 19:50,1,4,1,0,75,69,144
2023/2/3 20:00,1,4,1,0,86,66,152
2023/2/3 20:10,1,4,1,0,88,59,147
2023/2/3 20:20,1,4,1,0,74,55,129
2023/2/3 20:30,1,4,1,0,72,101,173
2023/2/3 20:40,1,4,1,0,69,203,272
2023/2/3 20:50,1,4,1,0,48,230,278
2023/2/3 21:00,1,4,1,0,54,185,239
2023/2/3 21:10,1,4,1,0,47,134,181
2023/2/3 21:20,1,4,1,0,33,110,143
2023/2/3 21:30,1,4,1,0,20,72,92
2023/2/3 21:40,1,4,1,0,17,81,98
2023/2/3 21:50,1,4,1,0,19,83,102
2023/2/3 22:00,1,4,1,0,14,80,94
2023/2/3 22:10,1,4,1,0,17,81,98
2023/2/3 22:20,1,4,1,0,16,47,63
2023/2/3 22:30,1,4,1,0,14,36,50
2023/2/3 22:40,1,4,1,0,11,22,33
2023/2/3 22:50,1,4,1,0,11,15,26
2023/2/3 23:00,1,4,1,0,11,10,21
2023/2/3 23:10,1,4,1,0,7,13,20
2023/2/3 23:20,1,4,1,0,4,10,14
2023/2/3 23:30,1,4,1,0,1,10,11
2023/2/3 23:40,1,4,1,0,2,9,11
2023/2/3 23:50,1,4,1,0,2,5,7
2023/2/4 0:00,1,4,0,0,1,2,3
2023/2/4 0:10,1,4,0,0,2,2,4
2023/2/4 0:20,1,4,0,0,1,1,2
2023/2/4 0:30,1,4,0,0,0,2,2
2023/2/4 0:40,1,4,0,0,0,2,2
2023/2/4 0:50,1,4,0,0,1,1,2
2023/2/4 1:00,1,4,0,0,1,1,2
2023/2/4 1:10,1,4,0,0,0,0,0
2023/2/4 1:20,1,4,0,0,1,2,3
2023/2/4 1:30,1,4,0,0,0,2,2
2023/2/4 1:40,1,4,0,0,2,0,2
2023/2/4 1:50,1,4,0,0,2,1,3
2023/2/4 2:00,1,4,0,0,0,2,2
2023/2/4 2:10,1,4,0,0,2,2,4
2023/2/4 2:20,1,4,0,0,1,2,3
2023/2/4 2:30,1,4,0,0,0,2,2
2023/2/4 2:40,1,4,0,0,0,0,0
2023/2/4 2:50,1,4,0,0,2,1,3
2023/2/4 3:00,1,4,0,0,2,1,3
2023/2/4 3:10,1,4,0,0,0,0,0
2023/2/4 3:20,1,4,0,0,0,2,2
2023/2/4 3:30,1,4,0,0,1,2,3
2023/2/4 3:40,1,4,0,0,1,1,2
2023/2/4 3:50,1,4,0,0,2,0,2
2023/2/4 4:00,1,4,0,0,0,1,1
2023/2/4 4:10,1,4,0,0,0,1,1
2023/2/4 4:20,1,4,0,0,2,1,3
2023/2/4 4:30,1,4,0,0,0,2,2
2023/2/4 4:40,1,4,0,0,1,0,1
2023/2/4 4:50,1,4,0,0,2,1,3
2023/2/4 5:00,1,4,0,0,2,1,3
2023/2/4 5:10,1,4,0,0,1,1,2
2023/2/4 5:20,1,4,0,0,2,1,3
2023/2/4 5:30,1,4,0,0,0,2,2
2023/2/4 5:40,1,4,0,0,1,0,1
2023/2/4 5:50,1,4,0,0,2,2,4
2023/2/4 6:00,1,4,0,0,4,0,4
2023/2/4 6:10,1,4,0,0,6,1,7
2023/2/4 6:20,1,4,0,0,5,2,7
2023/2/4 6:30,1,4,0,0,8,2,10
2023/2/4 6:40,1,4,0,0,11,0,11
2023/2/4 6:50,1,4,0,0,8,4,12
2023/2/4 7:00,1,4,0,0,14,1,15
2023/2/4 7:10,1,4,0,0,19,2,21
2023/2/4 7:20,1,4,0,0,42,2,44
2023/2/4 7:30,1,4,0,0,58,3,61
2023/2/4 7:40,1,4,0,0,59,2,61
2023/2/4 7:50,1,4,0,0,49,2,51
2023/2/4 8:00,1,4,0,0,49,5,54
2023/2/4 8:10,1,4,0,0,38,3,41
2023/2/4 8:20,1,4,0,0,32,1,33
2023/2/4 8:30,1,4,0,0,34,2,36
2023/2/4 8:40,1,4,0,0,27,3,30
2023/2/4 8:50,1,4,0,0,31,4,35
2023/2/4 9:00,1,4,0,0,32,2,34
2023/2/4 9:10,1,4,0,0,33,4,37
2023/2/4 9:20,1,4,0,0,36,6,42
2023/2/4 9:30,1,4,0,0,35,14,49
2023/2/4 9:40,1,4,0,0,40,17,57
2023/2/4 9:50,1,4,0,0,35,8,43
2023/2/4 10:00,1,4,0,0,37,15,52
2023/2/4 10:10,1,4,0,0,26,11,37
2023/2/4 10:20,1,4,0,0,23,11,34
2023/2/4 10:30,1,4,0,0,21,12,33
2023/2/4 10:40,1,4,0,0,21,16,37
2023/2/4 10:50,1,4,0,0,21,16,37
2023/2/4 11:00,1,4,0,0,14,19,33
2023/2/4 11:10,1,4,0,0,16,19,35
2023/2/4 11:20,1,4,0,0,14,20,34
2023/2/4 11:30,1,4,0,0,14,20,34
2023/2/4 11:40,1,4,0,0,9,27,36
2023/2/4 11:50,1,5,0,0,10,28,38
2023/2/4 12:00,1,5,0,0,13,30,43
2023/2/4 12:10,1,5,0,0,13,29,42
2023/2/4 12:20,1,5,0,0,14,27,41
2023/2/4 12:30,1,5,0,0,15,29,44
2023/2/4 12:40,1,5,0,0,11,33,44
2023/2/4 12:50,1,5,0,0,11,24,35
2023/2/4 13:00,1,5,0,0,12,20,32
2023/2/4 13:10,1,5,0,0,10,20,30
2023/2/4 13:20,1,5,0,0,17,14,31
2023/2/4 13:30,1,5,0,0,14,16,30
2023/2/4 13:40,1,5,0,0,29,16,45
2023/2/4 13:50,1,5,0,0,24,19,43
2023/2/4 14:00,1,5,0,0,21,19,40
2023/2/4 14:10,1,5,0,0,19,19,38
2023/2/4 14:20,1,5,0,0,16,14,30
2023/2/4 14:30,1,5,0,0,15,19,34
2023/2/4 14:40,1,5,0,0,18,14,32
2023/2/4 14:50,1,5,0,0,15,13,28
2023/2/4 15:00,1,5,0,0,20,9,29
2023/2/4 15:10,1,5,0,0,26,12,38
2023/2/4 15:20,1,5,0,0,23,15,38
2023/2/4 15:30,1,5,0,0,23,16,39
2023/2/4 15:40,1,5,0,0,20,21,41
2023/2/4 15:50,1,5,0,0,31,18,49
2023/2/4 16:00,1,5,0,0,25,15,40
2023/2/4 16:10,1,5,0,0,22,18,40
2023/2/4 16:20,1,5,0,0,24,14,38
2023/2/4 16:30,1,5,0,0,30,11,41
2023/2/4 16:40,1,5,0,0,31,9,40
2023/2/4 16:50,1,5,0,0,34,18,52
2023/2/4 17:00,1,5,0,0,37,20,57
2023/2/4 17:10,1,5,0,0,35,19,54
2023/2/4 17:20,1,5,0,0,42,23,65
2023/2/4 17:30,1,5,0,0,36,26,62
2023/2/4 17:40,1,5,0,0,33,28,61
2023/2/4 17:50,1,5,0,0,36,36,72
2023/2/4 18:00,1,5,0,0,44,29,73
2023/2/4 18:10,1,5,0,0,42,31,73
2023/2/4 18:20,1,5,0,0,40,28,68
2023/2/4 18:30,1,5,0,0,42,28,70
2023/2/4 18:40,1,5,0,0,40,23,63
2023/2/4 18:50,1,5,0,0,37,30,67
2023/2/4 19:00,1,5,0,0,35,24,59
2023/2/4 19:10,1,5,0,0,29,23,52
2023/2/4 19:20,1,5,0,0,24,17,41
2023/2/4 19:30,1,5,0,0,26,17,43
2023/2/4 19:40,1,5,0,0,24,18,42
2023/2/4 19:50,1,5,0,0,23,16,39
2023/2/4 20:00,1,5,0,0,22,24,46
2023/2/4 20:10,1,5,0,0,15,18,33
2023/2/4 20:20,1,5,0,0,15,25,40
2023/2/4 20:30,1,5,0,0,18,29,47
2023/2/4 20:40,1,5,0,0,18,33,51
2023/2/4 20:50,1,5,0,0,13,32,45
2023/2/4 21:00,1,5,0,0,12,30,42
2023/2/4 21:10,1,5,0,0,15,28,43
2023/2/4 21:20,1,5,0,0,9,27,36
2023/2/4 21:30,1,5,0,0,11,26,37
2023/2/4 21:40,1,5,0,0,6,42,48
2023/2/4 21:50,1,5,0,0,10,39,49
2023/2/4 22:00,1,5,0,0,6,31,37
2023/2/4 22:10,1,5,0,0,4,29,33
2023/2/4 22:20,1,5,0,0,2,24,26
2023/2/4 22:30,1,5,0,0,3,20,23
2023/2/4 22:40,1,5,0,0,3,11,14
2023/2/4 22:50,1,5,0,0,4,9,13
2023/2/4 23:00,1,5,0,0,1,7,8
2023/2/4 23:10,1,5,0,0,2,4,6
2023/2/4 23:20,1,5,0,0,2,3,5
2023/2/4 23:30,1,5,0,0,0,1,1
2023/2/4 23:40,1,5,0,0,1,2,3
2023/2/4 23:50,1,5,0,0,1,0,1
2023/2/5 0:00,1,5,0,0,3,3,6
2023/2/5 0:10,1,5,0,0,2,0,2
2023/2/5 0:20,1,5,0,0,0,1,1
2023/2/5 0:30,1,5,0,0,1,2,3
2023/2/5 0:40,1,5,0,0,1,0,1
2023/2/5 0:50,1,5,0,0,2,2,4
2023/2/5 1:00,1,5,0,0,0,0,0
2023/2/5 1:10,1,5,0,0,1,0,1
2023/2/5 1:20,1,5,0,0,1,1,2
2023/2/5 1:30,1,5,0,0,1,0,1
2023/2/5 1:40,1,5,0,0,1,1,2
2023/2/5 1:50,1,5,0,0,2,2,4
2023/2/5 2:00,1,5,0,0,0,0,0
2023/2/5 2:10,1,5,0,0,1,2,3
2023/2/5 2:20,1,5,0,0,0,1,1
2023/2/5 2:30,1,5,0,0,0,0,0
2023/2/5 2:40,1,5,0,0,0,2,2
2023/2/5 2:50,1,5,0,0,0,1,1
2023/2/5 3:00,1,5,0,0,0,2,2
2023/2/5 3:10,1,5,0,0,2,2,4
2023/2/5 3:20,1,5,0,0,0,2,2
2023/2/5 3:30,1,5,0,0,2,1,3
2023/2/5 3:40,1,5,0,0,0,1,1
2023/2/5 3:50,1,5,0,0,2,0,2
2023/2/5 4:00,1,5,0,0,1,1,2
2023/2/5 4:10,1,5,0,0,2,2,4
2023/2/5 4:20,1,5,0,0,2,2,4
2023/2/5 4:30,1,5,0,0,0,0,0
2023/2/5 4:40,1,5,0,0,2,1,3
2023/2/5 4:50,1,5,0,0,1,1,2
2023/2/5 5:00,1,5,0,0,1,2,3
2023/2/5 5:10,1,5,0,0,0,0,0
2023/2/5 5:20,1,5,0,0,2,0,2
2023/2/5 5:30,1,5,0,0,0,1,1
2023/2/5 5:40,1,5,0,0,3,2,5
2023/2/5 5:50,1,5,0,0,2,2,4
2023/2/5 6:00,1,5,0,0,4,0,4
2023/2/5 6:10,1,5,0,0,6,2,8
2023/2/5 6:20,1,5,0,0,6,0,6
2023/2/5 6:30,1,5,0,0,8,4,12
2023/2/5 6:40,1,5,0,0,13,0,13
2023/2/5 6:50,1,5,0,0,8,3,11
2023/2/5 7:00,1,5,0,0,17,0,17
2023/2/5 7:10,1,5,0,0,18,3,21
2023/2/5 7:20,1,6,0,0,37,3,40
2023/2/5 7:30,1,6,0,0,46,4,50
2023/2/5 7:40,1,6,0,0,64,3,67
2023/2/5 7:50,1,6,0,0,54,3,57
2023/2/5 8:00,1,6,0,0,45,4,49
2023/2/5 8:10,1,6,0,0,44,2,46
2023/2/5 8:20,1,6,0,0,33,1,34
2023/2/5 8:30,1,6,0,0,34,1,35
2023/2/5 8:40,1,6,0,0,27,3,30
2023/2/5 8:50,1,6,0,0,33,3,36
2023/2/5 9:00,1,6,0,0,35,3,38
2023/2/5 9:10,1,6,0,0,31,6,37
2023/2/5 9:20,1,6,0,0,35,6,41
2023/2/5 9:30,1,6,0,0,31,14,45
2023/2/5 9:40,1,6,0,0,36,17,53
2023/2/5 9:50,1,6,0,0,41,10,51
2023/2/5 10:00,1,6,0,0,38,19,57
2023/2/5 10:10,1,6,0,0,27,9,36
2023/2/5 10:20,1,6,0,0,24,10,34
2023/2/5 10:30,1,6,0,0,23,14,37
2023/2/5 10:40,1,6,0,0,21,13,34
2023/2/5 10:50,1,6,0,0,16,15,31
2023/2/5 11:00,1,6,0,0,15,21,36
2023/2/5 11:10,1,6,0,0,16,20,36
2023/2/5 11:20,1,6,0,0,10,17,27
2023/2/5 11:30,1,7,0,0,14,23,37
2023/2/5 11:40,1,7,0,0,12,25,37
2023/2/5 11:50,1,7,0,0,10,29,39
2023/2/5 12:00,1,7,0,0,9,32,41
2023/2/5 12:10,1,7,0,0,12,26,38
2023/2/5 12:20,1,7,0,0,11,31,42
2023/2/5 12:30,1,7,0,0,14,28,42
2023/2/5 12:40,1,7,0,0,10,35,45
2023/2/5 12:50,1,7,0,0,10,27,37
2023/2/5 13:00,1,7,0,0,8,22,30
2023/2/5 13:10,1,7,0,0,14,16,30
2023/2/5 13:20,1,7,0,0,16,18,34
2023/2/5 13:30,1,7,0,0,14,16,30
2023/2/5 13:40,1,7,0,0,25,18,43
2023/2/5 13:50,1,7,0,0,24,20,44
2023/2/5 14:00,1,7,0,0,22,17,39
2023/2/5 14:10,1,7,0,0,18,18,36
2023/2/5 14:20,1,7,0,0,18,16,34
2023/2/5 14:30,1,7,0,0,14,19,33
2023/2/5 14:40,1,7,0,0,17,14,31
2023/2/5 14:50,1,7,0,0,18,15,33
2023/2/5 15:00,1,7,0,0,18,10,28
2023/2/5 15:10,1,7,0,0,23,11,34
2023/2/5 15:20,1,7,0,0,20,13,33
2023/2/5 15:30,1,7,0,0,23,18,41
2023/2/5 15:40,1,7,0,0,24,20,44
2023/2/5 15:50,1,7,0,0,29,14,43
2023/2/5 16:00,1,7,0,0,22,15,37
2023/2/5 16:10,1,7,0,0,26,18,44
2023/2/5 16:20,1,7,0,0,27,12,39
2023/2/5 16:30,1,7,0,0,27,12,39
2023/2/5 16:40,1,7,0,0,30,11,41
2023/2/5 16:50,1,7,0,0,37,17,54
2023/2/5 17:00,1,7,0,0,35,19,54
2023/2/5 17:10,1,7,0,0,31,23,54
2023/2/5 17:20,1,7,0,0,41,20,61
2023/2/5 17:30,1,7,0,0,38,22,60
2023/2/5 17:40,1,7,0,0,36,28,64
2023/2/5 17:50,1,7,0,0,37,38,75
2023/2/5 18:00,1,7,0,0,51,36,87
2023/2/5 18:10,1,7,0,0,39,30,69
2023/2/5 18:20,1,7,0,0,48,30,78
2023/2/5 18:30,1,7,0,0,37,31,68
2023/2/5 18:40,1,7,0,0,36,22,58
2023/2/5 18:50,1,7,0,0,39,30,69
2023/2/5 19:00,1,6,0,0,32,21,53
2023/2/5 19:10,1,6,0,0,31,23,54
2023/2/5 19:20,1,6,0,0,24,22,46
2023/2/5 19:30,1,6,0,0,20,20,40
2023/2/5 19:40,1,6,0,0,22,20,42
2023/2/5 19:50,1,6,0,0,20,18,38
2023/2/5 20:00,1,6,0,0,22,19,41
2023/2/5 20:10,1,6,0,0,19,21,40
2023/2/5 20:20,1,6,0,0,17,26,43
2023/2/5 20:30,1,6,0,0,17,32,49
2023/2/5 20:40,1,6,0,0,17,27,44
2023/2/5 20:50,1,6,0,0,17,33,50
2023/2/5 21:00,1,6,0,0,12,37,49
2023/2/5 21:10,1,6,0,0,17,24,41
2023/2/5 21:20,1,6,0,0,9,25,34
2023/2/5 21:30,1,6,0,0,8,21,29
2023/2/5 21:40,1,6,0,0,9,36,45
2023/2/5 21:50,1,6,0,0,7,39,46
2023/2/5 22:00,1,6,0,0,7,34,41
2023/2/5 22:10,1,6,0,0,3,33,36
2023/2/5 22:20,1,6,0,0,4,29,33
2023/2/5 22:30,1,6,0,0,3,18,21
2023/2/5 22:40,1,6,0,0,2,11,13
2023/2/5 22:50,1,6,0,0,2,8,10
2023/2/5 23:00,1,6,0,0,1,4,5
2023/2/5 23:10,1,6,0,0,3,4,7
2023/2/5 23:20,1,6,0,0,1,1,2
2023/2/5 23:30,1,5,0,0,0,0,0
2023/2/5 23:40,1,5,0,0,2,1,3
2023/2/5 23:50,1,5,0,0,0,1,1
2023/2/6 0:00,1,5,1,0,4,1,5
2023/2/6 0:10,1,5,1,0,2,0,2
2023/2/6 0:20,1,5,1,0,4,3,7
2023/2/6 0:30,1,5,1,0,1,0,1
2023/2/6 0:40,1,5,1,0,3,1,4
2023/2/6 0:50,1,5,1,0,0,1,1
2023/2/6 1:00,1,5,1,0,2,2,4
2023/2/6 1:10,1,5,1,0,0,0,0
2023/2/6 1:20,1,5,1,0,1,0,1
2023/2/6 1:30,1,5,1,0,2,1,3
2023/2/6 1:40,1,5,1,0,1,1,2
2023/2/6 1:50,1,5,1,0,0,2,2
2023/2/6 2:00,1,5,1,0,1,1,2
2023/2/6 2:10,1,5,1,0,0,1,1
2023/2/6 2:20,1,5,1,0,2,2,4
2023/2/6 2:30,1,5,1,0,1,1,2
2023/2/6 2:40,1,5,1,0,1,0,1
2023/2/6 2:50,1,5,1,0,2,1,3
2023/2/6 3:00,1,5,1,0,0,1,1
2023/2/6 3:10,1,5,1,0,2,1,3
2023/2/6 3:20,1,5,1,0,0,0,0
2023/2/6 3:30,1,5,1,0,1,0,1
2023/2/6 3:40,1,5,1,0,2,0,2
2023/2/6 3:50,1,5,1,0,2,0,2
2023/2/6 4:00,1,5,1,0,2,2,4
2023/2/6 4:10,1,5,1,0,2,0,2
2023/2/6 4:20,1,5,1,0,2,2,4
2023/2/6 4:30,1,5,1,0,0,2,2
2023/2/6 4:40,1,5,1,0,2,2,4
2023/2/6 4:50,1,5,1,0,2,0,2
2023/2/6 5:00,1,5,1,0,0,2,2
2023/2/6 5:10,1,5,1,0,0,2,2
2023/2/6 5:20,1,5,1,0,2,0,2
2023/2/6 5:30,1,5,1,0,2,0,2
2023/2/6 5:40,1,5,1,0,0,1,1
2023/2/6 5:50,1,5,1,0,3,1,4
2023/2/6 6:00,1,5,1,0,4,3,7
2023/2/6 6:10,1,5,1,0,3,1,4
2023/2/6 6:20,1,5,1,0,4,2,6
2023/2/6 6:30,1,5,1,0,6,3,9
2023/2/6 6:40,1,5,1,0,13,2,15
2023/2/6 6:50,1,5,1,0,42,0,42
2023/2/6 7:00,1,5,1,0,56,3,59
2023/2/6 7:10,1,5,1,0,102,2,104
2023/2/6 7:20,1,5,1,0,123,3,126
2023/2/6 7:30,1,5,1,0,305,2,307
2023/2/6 7:40,1,5,1,0,523,4,527
2023/2/6 7:50,1,6,1,0,616,6,622
2023/2/6 8:00,1,6,1,0,261,7,268
2023/2/6 8:10,1,6,1,0,129,11,140
2023/2/6 8:20,1,6,1,0,87,9,96
2023/2/6 8:30,1,6,1,0,89,11,100
2023/2/6 8:40,1,6,1,0,72,13,85
2023/2/6 8:50,1,6,1,0,68,14,82
2023/2/6 9:00,1,6,1,0,78,17,95
2023/2/6 9:10,1,6,1,0,77,16,93
2023/2/6 9:20,1,6,1,0,142,31,173
2023/2/6 9:30,1,6,1,0,229,48,277
2023/2/6 9:40,1,6,1,0,232,116,348
2023/2/6 9:50,1,6,1,0,168,159,327
2023/2/6 10:00,1,6,1,0,132,149,281
2023/2/6 10:10,1,6,1,0,77,105,182
2023/2/6 10:20,1,6,1,0,70,64,134
2023/2/6 10:30,1,6,1,0,62,45,107
2023/2/6 10:40,1,6,1,0,58,48,106
2023/2/6 10:50,1,6,1,0,65,46,111
2023/2/6 11:00,1,6,1,0,64,34,98
2023/2/6 11:10,1,6,1,0,58,41,99
2023/2/6 11:20,1,6,1,0,66,42,108
2023/2/6 11:30,1,6,1,0,60,76,136
2023/2/6 11:40,1,6,1,0,64,208,272
2023/2/6 11:50,1,6,1,0,63,308,371
2023/2/6 12:00,1,6,1,0,51,273,324
2023/2/6 12:10,1,7,1,0,54,200,254
2023/2/6 12:20,1,7,1,0,58,130,188
2023/2/6 12:30,1,7,1,0,70,77,147
2023/2/6 12:40,1,7,1,0,53,68,121
2023/2/6 12:50,1,7,1,0,63,47,110
2023/2/6 13:00,1,7,1,0,56,28,84
2023/2/6 13:10,1,7,1,0,57,33,90
2023/2/6 13:20,1,7,1,0,76,30,106
2023/2/6 13:30,1,7,1,0,165,34,199
2023/2/6 13:40,1,7,1,0,216,36,252
2023/2/6 13:50,1,7,1,0,225,37,262
2023/2/6 14:00,1,7,1,0,134,28,162
2023/2/6 14:10,1,7,1,0,119,40,159
2023/2/6 14:20,1,7,1,0,90,43,133
2023/2/6 14:30,1,7,1,0,92,43,135
2023/2/6 14:40,1,7,1,0,75,49,124
2023/2/6 14:50,1,7,1,0,79,45,124
2023/2/6 15:00,1,7,1,0,77,49,126
2023/2/6 15:10,1,7,1,0,68,42,110
2023/2/6 15:20,1,7,1,0,71,44,115
2023/2/6 15:30,1,7,1,0,81,72,153
2023/2/6 15:40,1,7,1,0,150,183,333
2023/2/6 15:50,1,7,1,0,137,226,363
2023/2/6 16:00,1,7,1,0,108,129,237
2023/2/6 16:10,1,7,1,0,94,114,208
2023/2/6 16:20,1,7,1,0,81,82,163
2023/2/6 16:30,1,7,1,0,85,61,146
2023/2/6 16:40,1,7,1,0,77,56,133
2023/2/6 16:50,1,7,1,0,74,61,135
2023/2/6 17:00,1,7,1,0,81,59,140
2023/2/6 17:10,1,7,1,0,65,59,124
2023/2/6 17:20,1,8,1,0,75,51,126
2023/2/6 17:30,1,8,1,0,74,87,161
2023/2/6 17:40,1,8,1,0,81,273,354
2023/2/6 17:50,1,8,1,0,87,231,318
2023/2/6 18:00,1,8,1,0,103,208,311
2023/2/6 18:10,1,8,1,0,80,136,216
2023/2/6 18:20,1,8,1,0,106,86,192
2023/2/6 18:30,1,8,1,0,108,89,197
2023/2/6 18:40,1,8,1,0,156,72,228
2023/2/6 18:50,1,8,1,0,171,76,247
2023/2/6 19:00,1,8,1,0,148,67,215
2023/2/6 19:10,1,8,1,0,113,57,170
2023/2/6 19:20,1,8,1,0,100,68,168
2023/2/6 19:30,1,8,1,0,100,53,153
2023/2/6 19:40,1,8,1,0,88,53,141
2023/2/6 19:50,1,8,1,0,87,56,143
2023/2/6 20:00,1,8,1,0,90,62,152
2023/2/6 20:10,1,8,1,0,89,65,154
2023/2/6 20:20,1,8,1,0,87,59,146
2023/2/6 20:30,1,8,1,0,72,100,172
2023/2/6 20:40,1,8,1,0,63,169,232
2023/2/6 20:50,1,8,1,0,48,231,279
2023/2/6 21:00,1,8,1,0,46,183,229
2023/2/6 21:10,1,8,1,0,54,143,197
2023/2/6 21:20,1,8,1,0,27,118,145
2023/2/6 21:30,1,8,1,0,21,66,87
2023/2/6 21:40,1,8,1,0,18,71,89
2023/2/6 21:50,1,8,1,0,15,71,86
2023/2/6 22:00,1,8,1,0,14,82,96
2023/2/6 22:10,1,8,1,0,15,68,83
2023/2/6 22:20,1,8,1,0,16,49,65
2023/2/6 22:30,1,8,1,0,15,31,46
2023/2/6 22:40,1,8,1,0,9,22,31
2023/2/6 22:50,1,8,1,0,12,14,26
2023/2/6 23:00,1,8,1,0,9,12,21
2023/2/6 23:10,1,8,1,0,5,10,15
2023/2/6 23:20,1,8,1,0,5,12,17
2023/2/6 23:30,1,8,1,0,3,9,12
2023/2/6 23:40,1,8,1,0,1,11,12
2023/2/6 23:50,1,8,1,0,2,4,6
2023/2/7 0:00,1,8,1,0,5,0,5
2023/2/7 0:10,1,8,1,0,4,0,4
2023/2/7 0:20,1,8,1,0,2,1,3
2023/2/7 0:30,1,8,1,0,1,0,1
2023/2/7 0:40,1,8,1,0,1,1,2
2023/2/7 0:50,1,8,1,0,1,1,2
2023/2/7 1:00,1,8,1,0,0,2,2
2023/2/7 1:10,1,8,1,0,1,2,3
2023/2/7 1:20,1,8,1,0,2,0,2
2023/2/7 1:30,1,8,1,0,1,2,3
2023/2/7 1:40,1,8,1,0,2,0,2
2023/2/7 1:50,1,8,1,0,0,0,0
2023/2/7 2:00,1,8,1,0,1,0,1
2023/2/7 2:10,1,8,1,0,0,2,2
2023/2/7 2:20,1,8,1,0,1,0,1
2023/2/7 2:30,1,8,1,0,0,0,0
2023/2/7 2:40,1,8,1,0,2,2,4
2023/2/7 2:50,1,8,1,0,2,0,2
2023/2/7 3:00,1,8,1,0,1,0,1
2023/2/7 3:10,1,8,1,0,0,0,0
2023/2/7 3:20,1,8,1,0,1,1,2
2023/2/7 3:30,1,8,1,0,1,0,1
2023/2/7 3:40,1,8,1,0,0,2,2
2023/2/7 3:50,1,8,1,0,2,2,4
2023/2/7 4:00,1,8,1,0,0,0,0
2023/2/7 4:10,1,8,1,0,2,0,2
2023/2/7 4:20,1,8,1,0,0,1,1
2023/2/7 4:30,1,8,1,0,0,1,1
2023/2/7 4:40,1,8,1,0,1,2,3
2023/2/7 4:50,1,8,1,0,2,0,2
2023/2/7 5:00,1,8,1,0,1,1,2
2023/2/7 5:10,1,8,1,0,1,2,3
2023/2/7 5:20,1,8,1,0,0,2,2
2023/2/7 5:30,1,8,1,0,2,2,4
2023/2/7 5:40,1,8,1,0,0,0,0
2023/2/7 5:50,1,8,1,0,3,1,4
2023/2/7 6:00,1,8,1,0,4,2,6
2023/2/7 6:10,1,8,1,0,4,1,5
2023/2/7 6:20,1,8,1,0,5,3,8
2023/2/7 6:30,1,8,1,0,7,3,10
2023/2/7 6:40,1,8,1,0,13,1,14
2023/2/7 6:50,1,8,1,0,37,0,37
2023/2/7 7:00,1,8,1,0,55,3,58
2023/2/7 7:10,1,8,1,0,96,1,97
2023/2/7 7:20,1,8,1,0,105,3,108
2023/2/7 7:30,1,8,1,0,286,1,287
2023/2/7 7:40,1,8,1,0,593,4,597
2023/2/7 7:50,1,8,1,0,641,3,644
2023/2/7 8:00,1,8,1,0,257,6,263
2023/2/7 8:10,1,8,1,0,151,12,163
2023/2/7 8:20,1,8,1,0,106,9,115
2023/2/7 8:30,1,8,1,0,84,14,98
2023/2/7 8:40,1,8,1,0,89,16,105
2023/2/7 8:50,1,8,1,0,74,13,87
2023/2/7 9:00,1,8,1,0,78,14,92
2023/2/7 9:10,1,8,1,0,81,15,96
2023/2/7 9:20,1,8,1,0,158,29,187
2023/2/7 9:30,1,8,1,0,221,45,266
2023/2/7 9:40,1,8,1,0,239,144,383
2023/2/7 9:50,1,8,1,0,176,177,353
2023/2/7 10:00,1,8,1,0,142,132,274
2023/2/7 10:10,1,8,1,0,87,110,197
2023/2/7 10:20,1,8,1,0,70,71,141
2023/2/7 10:30,1,8,1,0,67,56,123
2023/2/7 10:40,1,8,1,0,62,44,106
2023/2/7 10:50,1,8,1,0,71,43,114
2023/2/7 11:00,1,8,1,0,71,40,111
2023/2/7 11:10,1,8,1,0,61,40,101
2023/2/7 11:20,1,8,1,0,68,43,111
2023/2/7 11:30,1,8,1,0,67,63,130
2023/2/7 11:40,1,8,1,0,76,195,271
2023/2/7 11:50,1,9,1,0,73,307,380
2023/2/7 12:00,1,9,1,0,65,265,330
2023/2/7 12:10,1,9,1,0,61,186,247
2023/2/7 12:20,1,9,1,0,56,131,187
2023/2/7 12:30,1,9,1,0,63,86,149
2023/2/7 12:40,1,9,1,0,53,58,111
2023/2/7 12:50,1,9,1,0,58,56,114
2023/2/7 13:00,1,9,1,0,66,31,97
2023/2/7 13:10,1,9,1,0,58,37,95
2023/2/7 13:20,1,9,1,0,82,33,115
2023/2/7 13:30,1,9,1,0,170,32,202
2023/2/7 13:40,1,9,1,0,224,38,262
2023/2/7 13:50,1,9,1,0,239,33,272
2023/2/7 14:00,1,9,1,0,113,28,141
2023/2/7 14:10,1,9,1,0,102,35,137
2023/2/7 14:20,1,9,1,0,88,43,131
2023/2/7 14:30,1,9,1,0,98,45,143
2023/2/7 14:40,1,9,1,0,75,45,120
2023/2/7 14:50,1,9,1,0,79,40,119
2023/2/7 15:00,1,9,1,0,81,44,125
2023/2/7 15:10,1,9,1,0,74,46,120
2023/2/7 15:20,1,9,1,0,69,42,111
2023/2/7 15:30,1,9,1,0,84,65,149
2023/2/7 15:40,1,9,1,0,147,193,340
2023/2/7 15:50,1,9,1,0,173,241,414
2023/2/7 16:00,1,9,1,0,103,135,238
2023/2/7 16:10,1,9,1,0,92,116,208
2023/2/7 16:20,1,9,1,0,86,83,169
2023/2/7 16:30,1,9,1,0,72,69,141
2023/2/7 16:40,1,9,1,0,74,59,133
2023/2/7 16:50,1,9,1,0,81,67,148
2023/2/7 17:00,1,9,1,0,75,59,134
2023/2/7 17:10,1,9,1,0,61,52,113
2023/2/7 17:20,1,9,1,0,77,53,130
2023/2/7 17:30,1,9,1,0,83,87,170
2023/2/7 17:40,1,9,1,0,89,223,312
2023/2/7 17:50,1,9,1,0,89,251,340
2023/2/7 18:00,1,9,1,0,94,194,288
2023/2/7 18:10,1,9,1,0,88,140,228
2023/2/7 18:20,1,9,1,0,85,106,191
2023/2/7 18:30,1,9,1,0,116,91,207
2023/2/7 18:40,1,9,1,0,189,67,256
2023/2/7 18:50,1,9,1,0,172,65,237
2023/2/7 19:00,1,9,1,0,116,56,172
2023/2/7 19:10,1,9,1,0,117,62,179
2023/2/7 19:20,1,9,1,0,108,56,164
2023/2/7 19:30,1,9,1,0,97,54,151
2023/2/7 19:40,1,9,1,0,92,55,147
2023/2/7 19:50,1,9,1,0,90,71,161
2023/2/7 20:00,1,9,1,0,84,75,159
2023/2/7 20:10,1,9,1,0,89,59,148
2023/2/7 20:20,1,9,1,0,77,57,134
2023/2/7 20:30,1,9,1,0,57,100,157
2023/2/7 20:40,1,9,1,0,67,210,277
2023/2/7 20:50,1,9,1,0,53,256,309
2023/2/7 21:00,1,9,1,0,53,159,212
2023/2/7 21:10,1,9,1,0,51,114,165
2023/2/7 21:20,1,9,1,0,29,115,144
2023/2/7 21:30,1,9,1,0,25,79,104
2023/2/7 21:40,1,9,1,0,20,70,90
2023/2/7 21:50,1,9,1,0,17,90,107
2023/2/7 22:00,1,9,1,0,18,88,106
2023/2/7 22:10,1,9,1,0,16,77,93
2023/2/7 22:20,1,9,1,0,18,44,62
2023/2/7 22:30,1,9,1,0,14,38,52
2023/2/7 22:40,1,9,1,0,10,22,32
2023/2/7 22:50,1,9,1,0,8,14,22
2023/2/7 23:00,1,9,1,0,9,11,20
2023/2/7 23:10,1,9,1,0,6,11,17
2023/2/7 23:20,1,9,1,0,5,12,17
2023/2/7 23:30,1,9,1,0,2,9,11
2023/2/7 23:40,1,9,1,0,2,8,10
2023/2/7 23:50,1,9,1,0,2,3,5
2023/2/8 0:00,1,9,1,0,4,1,5
2023/2/8 0:10,1,9,1,0,3,2,5
2023/2/8 0:20,1,9,1,0,4,1,5
2023/2/8 0:30,1,9,1,0,2,2,4
2023/2/8 0:40,1,9,1,0,2,2,4
2023/2/8 0:50,1,9,1,0,0,1,1
2023/2/8 1:00,1,9,1,0,2,1,3
2023/2/8 1:10,1,9,1,0,1,1,2
2023/2/8 1:20,1,9,1,0,0,1,1
2023/2/8 1:30,1,9,1,0,0,1,1
2023/2/8 1:40,1,9,1,0,2,1,3
2023/2/8 1:50,1,9,1,0,2,1,3
2023/2/8 2:00,1,9,1,0,0,2,2
2023/2/8 2:10,1,9,1,0,0,0,0
2023/2/8 2:20,1,9,1,0,1,1,2
2023/2/8 2:30,1,9,1,0,1,2,3
2023/2/8 2:40,1,9,1,0,0,1,1
2023/2/8 2:50,1,9,1,0,0,1,1
2023/2/8 3:00,1,9,1,0,0,0,0
2023/2/8 3:10,1,9,1,0,2,0,2
2023/2/8 3:20,1,9,1,0,0,2,2
2023/2/8 3:30,1,9,1,0,2,2,4
2023/2/8 3:40,1,9,1,0,2,2,4
2023/2/8 3:50,1,9,1,0,1,2,3
2023/2/8 4:00,1,9,1,0,0,1,1
2023/2/8 4:10,1,9,1,0,0,1,1
2023/2/8 4:20,1,9,1,0,2,1,3
2023/2/8 4:30,1,9,1,0,0,1,1
2023/2/8 4:40,1,9,1,0,1,1,2
2023/2/8 4:50,1,9,1,0,1,0,1
2023/2/8 5:00,1,9,1,0,0,0,0
2023/2/8 5:10,1,9,1,0,2,1,3
2023/2/8 5:20,1,9,1,0,0,2,2
2023/2/8 5:30,1,9,1,0,2,2,4
2023/2/8 5:40,1,9,1,0,0,1,1
2023/2/8 5:50,1,9,1,0,3,2,5
2023/2/8 6:00,1,9,1,0,4,2,6
2023/2/8 6:10,1,9,1,0,3,3,6
2023/2/8 6:20,1,9,1,0,5,3,8
2023/2/8 6:30,1,9,1,0,5,3,8
2023/2/8 6:40,1,9,1,0,11,2,13
2023/2/8 6:50,1,9,1,0,36,0,36
2023/2/8 7:00,1,10,1,0,66,4,70
2023/2/8 7:10,1,10,1,0,91,1,92
2023/2/8 7:20,1,10,1,0,101,3,104
2023/2/8 7:30,1,10,1,0,305,0,305
2023/2/8 7:40,1,10,1,0,572,3,575
2023/2/8 7:50,1,10,1,0,561,3,564
2023/2/8 8:00,1,10,1,0,292,7,299
2023/2/8 8:10,1,10,1,0,135,9,144
2023/2/8 8:20,1,10,1,0,104,9,113
2023/2/8 8:30,1,10,1,0,88,15,103
2023/2/8 8:40,1,10,1,0,84,16,100
2023/2/8 8:50,1,10,1,0,84,11,95
2023/2/8 9:00,1,10,1,0,80,13,93
2023/2/8 9:10,1,10,1,0,80,16,96
2023/2/8 9:20,1,10,1,0,155,32,187
2023/2/8 9:30,1,10,1,0,238,40,278
2023/2/8 9:40,1,10,1,0,257,118,375
2023/2/8 9:50,1,10,1,0,194,179,373
2023/2/8 10:00,1,10,1,0,128,164,292
2023/2/8 10:10,1,10,1,0,80,103,183
2023/2/8 10:20,1,10,1,0,75,72,147
2023/2/8 10:30,1,10,1,0,54,52,106
2023/2/8 10:40,1,10,1,0,70,43,113
2023/2/8 10:50,1,10,1,0,75,43,118
2023/2/8 11:00,1,10,1,0,75,38,113
2023/2/8 11:10,1,10,1,0,68,37,105
2023/2/8 11:20,1,10,1,0,57,46,103
2023/2/8 11:30,1,10,1,0,62,80,142
2023/2/8 11:40,1,10,1,0,82,215,297
2023/2/8 11:50,1,10,1,0,75,294,369
2023/2/8 12:00,1,10,1,0,62,266,328
2023/2/8 12:10,1,10,1,0,55,188,243
2023/2/8 12:20,1,10,1,0,60,106,166
2023/2/8 12:30,1,10,1,0,37,89,126
2023/2/8 12:40,1,10,1,0,32,68,100
2023/2/8 12:50,1,10,1,0,21,52,73
2023/2/8 13:00,1,10,1,0,14,26,40
2023/2/8 13:10,1,10,1,0,14,19,33
2023/2/8 13:20,1,10,1,0,14,17,31
2023/2/8 13:30,1,10,1,0,17,18,35
2023/2/8 13:40,1,10,1,0,26,21,47
2023/2/8 13:50,1,9,1,0,26,24,50
2023/2/8 14:00,1,9,1,0,27,24,51
2023/2/8 14:10,1,9,1,0,19,27,46
2023/2/8 14:20,1,9,1,0,20,18,38
2023/2/8 14:30,1,9,1,0,17,18,35
2023/2/8 14:40,1,9,1,0,16,17,33
2023/2/8 14:50,1,9,1,0,24,15,39
2023/2/8 15:00,1,9,1,0,27,12,39
2023/2/8 15:10,1,9,1,0,28,15,43
2023/2/8 15:20,1,9,1,0,26,18,44
2023/2/8 15:30,1,9,1,0,34,17,51
2023/2/8 15:40,1,9,1,0,32,20,52
2023/2/8 15:50,1,9,1,0,29,20,49
2023/2/8 16:00,1,9,1,0,28,19,47
2023/2/8 16:10,1,9,1,0,33,21,54
2023/2/8 16:20,1,9,1,0,32,15,47
2023/2/8 16:30,1,9,1,0,32,14,46
2023/2/8 16:40,1,8,1,0,38,12,50
2023/2/8 16:50,1,8,1,0,36,20,56
2023/2/8 17:00,1,8,1,0,41,23,64
2023/2/8 17:10,1,8,1,0,43,22,65
2023/2/8 17:20,1,8,1,0,44,27,71
2023/2/8 17:30,1,8,1,0,42,27,69
2023/2/8 17:40,1,8,1,0,40,33,73
2023/2/8 17:50,1,8,1,0,49,37,86
2023/2/8 18:00,1,8,1,0,59,38,97
2023/2/8 18:10,1,8,1,0,54,33,87
2023/2/8 18:20,1,8,1,0,51,30,81
2023/2/8 18:30,1,8,1,0,54,38,92
2023/2/8 18:40,1,8,1,0,46,34,80
2023/2/8 18:50,1,8,1,0,50,34,84
2023/2/8 19:00,1,8,1,0,45,24,69
2023/2/8 19:10,1,8,1,0,31,22,53
2023/2/8 19:20,1,8,1,0,27,23,50
2023/2/8 19:30,1,7,1,0,31,21,52
2023/2/8 19:40,1,7,1,0,32,20,52
2023/2/8 19:50,1,7,1,0,23,18,41
2023/2/8 20:00,1,7,1,0,29,24,53
2023/2/8 20:10,1,7,1,0,24,22,46
2023/2/8 20:20,1,7,1,0,19,32,51
2023/2/8 20:30,1,7,1,0,17,37,54
2023/2/8 20:40,1,7,1,0,20,40,60
2023/2/8 20:50,1,7,1,0,20,32,52
2023/2/8 21:00,1,7,1,0,15,39,54
2023/2/8 21:10,1,7,1,0,20,34,54
2023/2/8 21:20,1,7,1,0,15,33,48
2023/2/8 21:30,1,7,1,0,11,32,43
2023/2/8 21:40,1,7,1,0,9,42,51
2023/2/8 21:50,1,7,1,0,8,42,50
2023/2/8 22:00,1,7,1,0,6,47,53
2023/2/8 22:10,1,7,1,0,5,38,43
2023/2/8 22:20,1,7,1,0,2,29,31
2023/2/8 22:30,1,6,1,0,3,24,27
2023/2/8 22:40,1,6,1,0,3,13,16
2023/2/8 22:50,1,6,1,0,4,12,16
2023/2/8 23:00,1,6,1,0,3,8,11
2023/2/8 23:10,1,6,1,0,1,6,7
2023/2/8 23:20,1,6,1,0,0,1,1
2023/2/8 23:30,1,6,1,0,0,2,2
2023/2/8 23:40,1,6,1,0,1,3,4
2023/2/8 23:50,1,6,1,0,0,1,1
2023/2/9 0:00,1,6,1,0,4,2,6
2023/2/9 0:10,1,6,1,0,4,2,6
2023/2/9 0:20,1,6,1,0,4,2,6
2023/2/9 0:30,1,6,1,0,1,0,1
2023/2/9 0:40,1,5,1,0,2,0,2
2023/2/9 0:50,1,5,1,0,0,0,0
2023/2/9 1:00,1,5,1,0,0,2,2
2023/2/9 1:10,1,5,1,0,1,0,1
2023/2/9 1:20,1,5,1,0,2,0,2
2023/2/9 1:30,1,5,1,0,1,1,2
2023/2/9 1:40,1,5,1,0,1,2,3
2023/2/9 1:50,1,5,1,0,1,2,3
2023/2/9 2:00,1,5,1,0,0,1,1
2023/2/9 2:10,1,5,1,0,0,2,2
2023/2/9 2:20,1,5,1,0,2,0,2
2023/2/9 2:30,1,5,1,0,2,0,2
2023/2/9 2:40,1,5,1,0,0,0,0
2023/2/9 2:50,1,5,1,0,2,0,2
2023/2/9 3:00,1,5,1,0,0,2,2
2023/2/9 3:10,1,5,1,0,2,0,2
2023/2/9 3:20,1,5,1,0,2,1,3
2023/2/9 3:30,1,5,1,0,1,2,3
2023/2/9 3:40,1,5,1,0,0,0,0
2023/2/9 3:50,1,5,1,0,2,0,2
2023/2/9 4:00,1,5,1,0,2,2,4
2023/2/9 4:10,1,5,1,0,0,1,1
2023/2/9 4:20,1,5,1,0,1,2,3
2023/2/9 4:30,1,5,1,0,0,2,2
2023/2/9 4:40,1,5,1,0,1,2,3
2023/2/9 4:50,1,5,1,0,2,2,4
2023/2/9 5:00,1,5,1,0,1,1,2
2023/2/9 5:10,1,5,1,0,2,2,4
2023/2/9 5:20,1,5,1,0,1,1,2
2023/2/9 5:30,1,5,1,0,1,2,3
2023/2/9 5:40,1,5,1,0,1,2,3
2023/2/9 5:50,1,5,1,0,5,1,6
2023/2/9 6:00,1,5,1,0,3,3,6
2023/2/9 6:10,1,5,1,0,3,1,4
2023/2/9 6:20,1,5,1,0,6,3,9
2023/2/9 6:30,1,5,1,0,6,3,9
2023/2/9 6:40,1,5,1,0,14,2,16
2023/2/9 6:50,1,5,1,0,40,0,40
2023/2/9 7:00,1,5,1,0,58,2,60
2023/2/9 7:10,1,5,1,0,82,0,82
2023/2/9 7:20,1,5,1,0,107,1,108
2023/2/9 7:30,1,5,1,0,348,1,349
2023/2/9 7:40,1,6,1,0,553,3,556
2023/2/9 7:50,1,6,1,0,674,5,679
2023/2/9 8:00,1,6,1,0,310,8,318
2023/2/9 8:10,1,6,1,0,124,12,136
2023/2/9 8:20,1,6,1,0,106,10,116
2023/2/9 8:30,1,6,1,0,78,12,90
2023/2/9 8:40,1,6,1,0,76,14,90
2023/2/9 8:50,1,6,1,0,77,10,87
2023/2/9 9:00,1,6,1,0,81,15,96
2023/2/9 9:10,1,6,1,0,87,19,106
2023/2/9 9:20,1,6,1,0,134,28,162
2023/2/9 9:30,1,6,1,0,244,44,288
2023/2/9 9:40,1,6,1,0,227,113,340
2023/2/9 9:50,1,6,1,0,216,183,399
2023/2/9 10:00,1,6,1,0,138,156,294
2023/2/9 10:10,1,6,1,0,83,109,192
2023/2/9 10:20,1,6,1,0,69,75,144
2023/2/9 10:30,1,6,1,0,66,51,117
2023/2/9 10:40,1,6,1,0,71,43,114
2023/2/9 10:50,1,6,1,0,60,41,101
2023/2/9 11:00,1,6,1,0,68,43,111
2023/2/9 11:10,1,6,1,0,61,42,103
2023/2/9 11:20,1,6,1,0,65,45,110
2023/2/9 11:30,1,6,1,0,70,74,144
2023/2/9 11:40,1,6,1,0,76,220,296
2023/2/9 11:50,1,6,1,0,67,281,348
2023/2/9 12:00,1,6,1,0,66,258,324
2023/2/9 12:10,1,6,1,0,48,178,226
2023/2/9 12:20,1,6,1,0,60,119,179
2023/2/9 12:30,1,6,1,0,70,78,148
2023/2/9 12:40,1,6,1,0,66,58,124
2023/2/9 12:50,1,7,1,0,59,49,108
2023/2/9 13:00,1,7,1,0,55,31,86
2023/2/9 13:10,1,7,1,0,65,31,96
2023/2/9 13:20,1,7,1,0,76,33,109
2023/2/9 13:30,1,7,1,0,146,33,179
2023/2/9 13:40,1,7,1,0,209,37,246
2023/2/9 13:50,1,7,1,0,266,38,304
2023/2/9 14:00,1,7,1,0,128,33,161
2023/2/9 14:10,1,7,1,0,116,40,156
2023/2/9 14:20,1,7,1,0,99,42,141
2023/2/9 14:30,1,7,1,0,96,42,138
2023/2/9 14:40,1,7,1,0,83,46,129
2023/2/9 14:50,1,7,1,0,69,47,116
2023/2/9 15:00,1,7,1,0,77,40,117
2023/2/9 15:10,1,7,1,0,72,44,116
2023/2/9 15:20,1,7,1,0,71,39,110
2023/2/9 15:30,1,7,1,0,93,66,159
2023/2/9 15:40,1,7,1,0,143,179,322
2023/2/9 15:50,1,7,1,0,168,219,387
2023/2/9 16:00,1,7,1,0,101,139,240
2023/2/9 16:10,1,7,1,0,97,119,216
2023/2/9 16:20,1,7,1,0,75,71,146
2023/2/9 16:30,1,7,1,0,72,72,144
2023/2/9 16:40,1,7,1,0,79,53,132
2023/2/9 16:50,1,7,1,0,76,61,137
2023/2/9 17:00,1,7,1,0,80,52,132
2023/2/9 17:10,1,7,1,0,75,53,128
2023/2/9 17:20,1,7,1,0,76,53,129
2023/2/9 17:30,1,7,1,0,84,91,175
2023/2/9 17:40,1,7,1,0,77,237,314
2023/2/9 17:50,1,7,1,0,103,261,364
2023/2/9 18:00,1,7,1,0,81,190,271
2023/2/9 18:10,1,7,1,0,81,137,218
2023/2/9 18:20,1,7,1,0,91,98,189
2023/2/9 18:30,1,7,1,0,101,77,178
2023/2/9 18:40,1,7,1,0,189,63,252
2023/2/9 18:50,1,7,1,0,174,60,234
2023/2/9 19:00,1,7,1,0,131,60,191
2023/2/9 19:10,1,7,1,0,111,65,176
2023/2/9 19:20,1,7,1,0,93,67,160
2023/2/9 19:30,1,7,1,0,95,65,160
2023/2/9 19:40,1,7,1,0,86,63,149
2023/2/9 19:50,1,7,1,0,78,66,144
2023/2/9 20:00,1,7,1,0,81,70,151
2023/2/9 20:10,1,7,1,0,87,64,151
2023/2/9 20:20,1,7,1,0,70,71,141
2023/2/9 20:30,1,7,1,0,59,83,142
2023/2/9 20:40,1,7,1,0,57,200,257
2023/2/9 20:50,1,7,1,0,60,237,297
2023/2/9 21:00,1,7,1,0,53,182,235
2023/2/9 21:10,1,7,1,0,50,131,181
2023/2/9 21:20,1,7,1,0,30,95,125
2023/2/9 21:30,1,7,1,0,21,66,87
2023/2/9 21:40,1,7,1,0,18,72,90
2023/2/9 21:50,1,7,1,0,15,80,95
2023/2/9 22:00,1,7,1,0,16,92,108
2023/2/9 22:10,1,7,1,0,17,80,97
2023/2/9 22:20,1,7,1,0,18,46,64
2023/2/9 22:30,1,7,1,0,15,36,51
2023/2/9 22:40,1,7,1,0,13,19,32
2023/2/9 22:50,1,7,1,0,10,12,22
2023/2/9 23:00,1,7,1,0,11,13,24
2023/2/9 23:10,1,7,1,0,8,14,22
2023/2/9 23:20,1,7,1,0,4,8,12
2023/2/9 23:30,1,7,1,0,2,10,12
2023/2/9 23:40,1,6,1,0,3,10,13
2023/2/9 23:50,1,6,1,0,2,5,7
2023/2/10 0:00,1,6,1,0,4,1,5
2023/2/10 0:10,1,6,1,0,2,2,4
2023/2/10 0:20,1,6,1,0,3,3,6
2023/2/10 0:30,1,6,1,0,2,1,3
2023/2/10 0:40,1,6,1,0,2,0,2
2023/2/10 0:50,1,6,1,0,0,0,0
2023/2/10 1:00,1,6,1,0,0,0,0
2023/2/10 1:10,1,6,1,0,0,2,2
2023/2/10 1:20,1,6,1,0,2,2,4
2023/2/10 1:30,1,6,1,0,1,2,3
2023/2/10 1:40,1,6,1,0,0,1,1
2023/2/10 1:50,1,6,1,0,2,1,3
2023/2/10 2:00,1,6,1,0,2,0,2
2023/2/10 2:10,1,6,1,0,2,2,4
2023/2/10 2:20,1,6,1,0,1,2,3
2023/2/10 2:30,1,6,1,0,2,0,2
2023/2/10 2:40,1,6,1,0,0,1,1
2023/2/10 2:50,1,6,1,0,0,1,1
2023/2/10 3:00,1,6,1,0,0,2,2
2023/2/10 3:10,1,6,1,0,1,0,1
2023/2/10 3:20,1,6,1,0,1,1,2
2023/2/10 3:30,1,6,1,0,1,0,1
2023/2/10 3:40,1,6,1,0,2,1,3
2023/2/10 3:50,1,6,1,0,0,1,1
2023/2/10 4:00,1,6,1,0,0,0,0
2023/2/10 4:10,1,6,1,0,1,2,3
2023/2/10 4:20,1,6,1,0,1,2,3
2023/2/10 4:30,1,6,1,0,0,0,0
2023/2/10 4:40,1,6,1,0,2,1,3
2023/2/10 4:50,1,6,1,0,0,0,0
2023/2/10 5:00,1,6,1,0,2,1,3
2023/2/10 5:10,1,6,1,0,1,2,3
2023/2/10 5:20,1,6,1,0,0,1,1
2023/2/10 5:30,1,6,1,0,1,2,3
2023/2/10 5:40,1,6,1,0,2,2,4
2023/2/10 5:50,1,6,1,0,5,2,7
2023/2/10 6:00,1,6,1,0,4,4,8
2023/2/10 6:10,1,6,1,0,3,2,5
2023/2/10 6:20,1,6,1,0,5,3,8
2023/2/10 6:30,1,6,1,0,5,4,9
2023/2/10 6:40,1,6,1,0,13,2,15
2023/2/10 6:50,1,6,1,0,43,0,43
2023/2/10 7:00,1,6,1,0,65,4,69
2023/2/10 7:10,1,6,1,0,92,0,92
2023/2/10 7:20,1,6,1,0,117,1,118
2023/2/10 7:30,1,6,1,0,332,0,332
2023/2/10 7:40,1,6,1,0,571,5,576
2023/2/10 7:50,1,6,1,0,566,3,569
2023/2/10 8:00,1,6,1,0,303,7,310
2023/2/10 8:10,1,6,1,0,143,8,151
2023/2/10 8:20,1,6,1,0,94,8,102
2023/2/10 8:30,1,6,1,0,86,11,97
2023/2/10 8:40,1,6,1,0,73,14,87
2023/2/10 8:50,1,6,1,0,83,12,95
2023/2/10 9:00,1,6,1,0,91,17,108
2023/2/10 9:10,1,6,1,0,79,19,98
2023/2/10 9:20,1,6,1,0,156,28,184
2023/2/10 9:30,1,6,1,0,204,37,241
2023/2/10 9:40,1,7,1,0,282,115,397
2023/2/10 9:50,1,7,1,0,211,184,395
2023/2/10 10:00,1,7,1,0,118,151,269
2023/2/10 10:10,1,7,1,0,87,95,182
2023/2/10 10:20,1,7,1,0,80,65,145
2023/2/10 10:30,1,7,1,0,70,53,123
2023/2/10 10:40,1,7,1,0,61,51,112
2023/2/10 10:50,1,7,1,0,70,40,110
2023/2/10 11:00,1,7,1,0,66,42,108
2023/2/10 11:10,1,7,1,0,68,39,107
2023/2/10 11:20,1,7,1,0,64,44,108
2023/2/10 11:30,1,7,1,0,78,76,154
2023/2/10 11:40,1,7,1,0,75,218,293
2023/2/10 11:50,1,7,1,0,64,270,334
2023/2/10 12:00,1,7,1,0,58,235,293
2023/2/10 12:10,1,7,1,0,60,172,232
2023/2/10 12:20,1,7,1,0,57,111,168
2023/2/10 12:30,1,7,1,0,65,91,156
2023/2/10 12:40,1,7,1,0,55,59,114
2023/2/10 12:50,1,7,1,0,61,47,108
2023/2/10 13:00,1,7,1,0,67,31,98
2023/2/10 13:10,1,7,1,0,67,29,96
2023/2/10 13:20,1,7,1,0,88,32,120
2023/2/10 13:30,1,7,1,0,168,36,204
2023/2/10 13:40,1,7,1,0,261,40,301
2023/2/10 13:50,1,7,1,0,274,34,308
2023/2/10 14:00,1,7,1,0,125,30,155
2023/2/10 14:10,1,7,1,0,119,36,155
2023/2/10 14:20,1,7,1,0,94,42,136
2023/2/10 14:30,1,7,1,0,77,39,116
2023/2/10 14:40,1,7,1,0,88,46,134
2023/2/10 14:50,1,7,1,0,78,42,120
2023/2/10 15:00,1,7,1,0,66,40,106
2023/2/10 15:10,1,7,1,0,73,38,111
2023/2/10 15:20,1,7,1,0,83,41,124
2023/2/10 15:30,1,7,1,0,83,63,146
2023/2/10 15:40,1,7,1,0,132,191,323
2023/2/10 15:50,1,7,1,0,138,220,358
2023/2/10 16:00,1,7,1,0,109,143,252
2023/2/10 16:10,1,7,1,0,80,120,200
2023/2/10 16:20,1,7,1,0,81,86,167
2023/2/10 16:30,1,7,1,0,69,75,144
2023/2/10 16:40,1,7,1,0,66,63,129
2023/2/10 16:50,1,7,1,0,79,69,148
2023/2/10 17:00,1,7,1,0,72,53,125
2023/2/10 17:10,1,7,1,0,62,58,120
2023/2/10 17:20,1,7,1,0,77,50,127
2023/2/10 17:30,1,7,1,0,76,91,167
2023/2/10 17:40,1,7,1,0,86,254,340
2023/2/10 17:50,1,7,1,0,87,235,322
2023/2/10 18:00,1,7,1,0,82,198,280
2023/2/10 18:10,1,7,1,0,77,144,221
2023/2/10 18:20,1,7,1,0,105,106,211
2023/2/10 18:30,1,7,1,0,113,78,191
2023/2/10 18:40,1,7,1,0,164,69,233
2023/2/10 18:50,1,7,1,0,181,75,256
2023/2/10 19:00,1,7,1,0,132,65,197
2023/2/10 19:10,1,7,1,0,129,69,198
2023/2/10 19:20,1,7,1,0,107,63,170
2023/2/10 19:30,1,7,1,0,88,66,154
2023/2/10 19:40,1,7,1,0,93,66,159
2023/2/10 19:50,1,7,1,0,85,56,141
2023/2/10 20:00,1,7,1,0,89,68,157
2023/2/10 20:10,1,7,1,0,74,70,144
2023/2/10 20:20,1,7,1,0,78,67,145
2023/2/10 20:30,1,7,1,0,64,89,153
2023/2/10 20:40,1,7,1,0,63,204,267
2023/2/10 20:50,1,7,1,0,54,245,299
2023/2/10 21:00,1,7,1,0,43,153,196
2023/2/10 21:10,1,7,1,0,45,139,184
2023/2/10 21:20,1,7,1,0,32,120,152
2023/2/10 21:30,1,7,1,0,24,72,96
2023/2/10 21:40,1,7,1,0,16,68,84
2023/2/10 21:50,1,7,1,0,20,84,104
2023/2/10 22:00,1,7,1,0,17,94,111
2023/2/10 22:10,1,7,1,0,14,71,85
2023/2/10 22:20,1,7,1,0,16,52,68
2023/2/10 22:30,1,7,1,0,16,36,52
2023/2/10 22:40,1,7,1,0,12,20,32
2023/2/10 22:50,1,6,1,0,8,11,19
2023/2/10 23:00,1,6,1,0,9,11,20
2023/2/10 23:10,1,6,1,0,6,14,20
2023/2/10 23:20,1,6,1,0,6,9,15
2023/2/10 23:30,1,6,1,0,2,9,11
2023/2/10 23:40,1,6,1,0,1,11,12
2023/2/10 23:50,1,6,1,0,2,5,7
2023/2/11 0:00,1,6,0,0,1,2,3
2023/2/11 0:10,1,6,0,0,1,2,3
2023/2/11 0:20,1,6,0,0,1,0,1
2023/2/11 0:30,1,6,0,0,2,0,2
2023/2/11 0:40,1,6,0,0,2,2,4
2023/2/11 0:50,1,6,0,0,2,1,3
2023/2/11 1:00,1,6,0,0,1,1,2
2023/2/11 1:10,1,6,0,0,0,2,2
2023/2/11 1:20,1,6,0,0,0,1,1
2023/2/11 1:30,1,6,0,0,1,0,1
2023/2/11 1:40,1,6,0,0,2,1,3
2023/2/11 1:50,1,6,0,0,1,1,2
2023/2/11 2:00,1,6,0,0,1,2,3
2023/2/11 2:10,1,6,0,0,1,1,2
2023/2/11 2:20,1,6,0,0,0,0,0
2023/2/11 2:30,1,6,0,0,1,2,3
2023/2/11 2:40,1,6,0,0,2,0,2
2023/2/11 2:50,1,6,0,0,1,0,1
2023/2/11 3:00,1,6,0,0,2,1,3
2023/2/11 3:10,1,6,0,0,0,2,2
2023/2/11 3:20,1,6,0,0,2,2,4
2023/2/11 3:30,1,6,0,0,1,2,3
2023/2/11 3:40,1,6,0,0,0,1,1
2023/2/11 3:50,1,6,0,0,0,1,1
2023/2/11 4:00,1,6,0,0,2,0,2
2023/2/11 4:10,1,6,0,0,1,0,1
2023/2/11 4:20,1,6,0,0,0,0,0
2023/2/11 4:30,1,6,0,0,1,2,3
2023/2/11 4:40,1,6,0,0,0,2,2
2023/2/11 4:50,1,6,0,0,1,0,1
2023/2/11 5:00,1,6,0,0,1,1,2
2023/2/11 5:10,1,6,0,0,1,0,1
2023/2/11 5:20,1,6,0,0,3,0,3
2023/2/11 5:30,1,6,0,0,2,1,3
2023/2/11 5:40,1,6,0,0,2,1,3
2023/2/11 5:50,1,6,0,0,3,0,3
2023/2/11 6:00,1,6,0,0,7,0,7
2023/2/11 6:10,1,6,0,0,6,2,8
2023/2/11 6:20,1,6,0,0,6,2,8
2023/2/11 6:30,1,6,0,0,8,4,12
2023/2/11 6:40,1,6,0,0,9,1,10
2023/2/11 6:50,1,6,0,0,11,2,13
2023/2/11 7:00,1,7,0,0,14,2,16
2023/2/11 7:10,1,7,0,0,18,3,21
2023/2/11 7:20,1,7,0,0,42,3,45
2023/2/11 7:30,1,7,0,0,48,4,52
2023/2/11 7:40,1,7,0,0,52,3,55
2023/2/11 7:50,1,7,0,0,53,1,54
2023/2/11 8:00,1,7,0,0,39,4,43
2023/2/11 8:10,1,7,0,0,36,3,39
2023/2/11 8:20,0,7,0,0,7,1,8
2023/2/11 8:30,0,7,0,0,8,0,8
2023/2/11 8:40,0,7,0,0,8,1,9
2023/2/11 8:50,0,7,0,0,9,1,10
2023/2/11 9:00,0,7,0,0,7,1,8
2023/2/11 9:10,0,7,0,0,8,2,10
2023/2/11 9:20,0,7,0,0,8,2,10
2023/2/11 9:30,0,8,0,0,9,3,12
2023/2/11 9:40,0,8,0,0,10,4,14
2023/2/11 9:50,0,8,0,0,9,3,12
2023/2/11 10:00,0,8,0,0,10,4,14
2023/2/11 10:10,0,8,0,0,7,3,10
2023/2/11 10:20,0,8,0,0,5,3,8
2023/2/11 10:30,0,8,0,0,6,3,9
2023/2/11 10:40,0,8,0,0,5,4,9
2023/2/11 10:50,0,8,0,0,5,4,9
2023/2/11 11:00,0,8,0,0,4,5,9
2023/2/11 11:10,0,8,0,0,4,4,8
2023/2/11 11:20,0,8,0,0,3,5,8
2023/2/11 11:30,0,8,0,0,4,5,9
2023/2/11 11:40,0,8,0,0,3,6,9
2023/2/11 11:50,0,8,0,0,3,7,10
2023/2/11 12:00,0,9,0,0,3,8,11
2023/2/11 12:10,0,9,0,0,4,7,11
2023/2/11 12:20,0,9,0,0,4,8,12
2023/2/11 12:30,0,9,0,0,4,8,12
2023/2/11 12:40,0,9,0,0,4,7,11
2023/2/11 12:50,0,9,0,0,3,6,9
2023/2/11 13:00,0,9,0,0,3,5,8
2023/2/11 13:10,0,9,0,0,4,5,9
2023/2/11 13:20,0,9,0,0,4,4,8
2023/2/11 13:30,0,9,0,0,4,4,8
2023/2/11 13:40,0,10,0,0,6,5,11
2023/2/11 13:50,0,10,0,0,6,4,10
2023/2/11 14:00,0,10,0,0,6,5,11
2023/2/11 14:10,0,10,0,0,5,5,10
2023/2/11 14:20,0,10,0,0,4,4,8
2023/2/11 14:30,0,10,0,0,4,4,8
2023/2/11 14:40,0,10,0,0,5,4,9
2023/2/11 14:50,0,10,0,0,5,4,9
2023/2/11 15:00,0,10,0,0,6,2,8
2023/2/11 15:10,0,10,0,0,5,3,8
2023/2/11 15:20,0,10,0,0,6,4,10
2023/2/11 15:30,0,10,0,0,6,4,10
2023/2/11 15:40,0,10,0,0,6,5,11
2023/2/11 15:50,0,10,0,0,8,4,12
2023/2/11 16:00,0,10,0,0,7,4,11
2023/2/11 16:10,0,10,0,0,6,4,10
2023/2/11 16:20,0,10,0,0,7,3,10
2023/2/11 16:30,0,10,0,0,7,3,10
2023/2/11 16:40,0,10,0,0,8,3,11
2023/2/11 16:50,0,10,0,0,9,4,13
2023/2/11 17:00,0,10,0,0,10,5,15
2023/2/11 17:10,0,10,0,0,8,5,13
2023/2/11 17:20,0,10,0,0,10,5,15
2023/2/11 17:30,0,10,0,0,9,7,16
2023/2/11 17:40,0,10,0,0,10,9,19
2023/2/11 17:50,0,10,0,0,9,10,19
2023/2/11 18:00,0,9,0,0,11,7,18
2023/2/11 18:10,0,9,0,0,10,7,17
2023/2/11 18:20,0,9,0,0,10,7,17
2023/2/11 18:30,0,9,0,0,9,8,17
2023/2/11 18:40,0,9,0,0,10,7,17
2023/2/11 18:50,0,9,0,0,10,7,17
2023/2/11 19:00,0,9,0,0,9,6,15
2023/2/11 19:10,0,9,0,0,8,6,14
2023/2/11 19:20,0,9,0,0,5,5,10
2023/2/11 19:30,0,9,0,0,6,5,11
2023/2/11 19:40,0,9,0,0,6,5,11
2023/2/11 19:50,0,8,0,0,6,5,11
2023/2/11 20:00,0,8,0,0,5,5,10
2023/2/11 20:10,0,8,0,0,5,5,10
2023/2/11 20:20,1,8,0,0,15,25,40
2023/2/11 20:30,1,8,0,0,16,25,41
2023/2/11 20:40,1,8,0,0,14,26,40
2023/2/11 20:50,1,8,0,0,16,28,44
2023/2/11 21:00,1,8,0,0,13,36,49
2023/2/11 21:10,1,8,0,0,13,28,41
2023/2/11 21:20,1,8,0,0,13,23,36
2023/2/11 21:30,1,8,0,0,9,21,30
2023/2/11 21:40,1,8,0,0,7,34,41
2023/2/11 21:50,1,8,0,0,7,45,52
2023/2/11 22:00,1,8,0,0,6,38,44
2023/2/11 22:10,1,8,0,0,5,30,35
2023/2/11 22:20,1,8,0,0,3,27,30
2023/2/11 22:30,1,7,0,0,3,19,22
2023/2/11 22:40,1,7,0,0,3,11,14
2023/2/11 22:50,1,7,0,0,2,11,13
2023/2/11 23:00,1,7,0,0,2,5,7
2023/2/11 23:10,1,7,0,0,2,5,7
2023/2/11 23:20,1,7,0,0,1,2,3
2023/2/11 23:30,1,7,0,0,1,0,1
2023/2/11 23:40,1,7,0,0,2,2,4
2023/2/11 23:50,1,7,0,0,0,1,1
2023/2/12 0:00,1,7,0,0,1,1,2
2023/2/12 0:10,1,7,0,0,0,2,2
2023/2/12 0:20,1,7,0,0,0,2,2
2023/2/12 0:30,1,7,0,0,2,2,4
2023/2/12 0:40,1,7,0,0,0,0,0
2023/2/12 0:50,1,7,0,0,1,2,3
2023/2/12 1:00,1,7,0,0,2,2,4
2023/2/12 1:10,1,7,0,0,1,0,1
2023/2/12 1:20,1,7,0,0,2,0,2
2023/2/12 1:30,1,7,0,0,0,1,1
2023/2/12 1:40,1,7,0,0,2,0,2
2023/2/12 1:50,1,7,0,0,1,2,3
2023/2/12 2:00,1,7,0,0,1,2,3
2023/2/12 2:10,1,6,0,0,1,0,1
2023/2/12 2:20,1,6,0,0,1,1,2
2023/2/12 2:30,1,6,0,0,0,2,2
2023/2/12 2:40,1,6,0,0,1,0,1
2023/2/12 2:50,1,6,0,0,1,1,2
2023/2/12 3:00,1,6,0,0,2,1,3
2023/2/12 3:10,1,6,0,0,2,1,3
2023/2/12 3:20,1,6,0,0,1,1,2
2023/2/12 3:30,1,6,0,0,0,2,2
2023/2/12 3:40,1,6,0,0,1,1,2
2023/2/12 3:50,1,6,0,0,2,1,3
2023/2/12 4:00,1,6,0,0,0,1,1
2023/2/12 4:10,1,6,0,0,2,1,3
2023/2/12 4:20,1,6,0,0,2,0,2
2023/2/12 4:30,1,6,0,0,0,0,0
2023/2/12 4:40,1,6,0,0,2,0,2
2023/2/12 4:50,1,6,0,0,1,1,2
2023/2/12 5:00,1,6,0,0,1,1,2
2023/2/12 5:10,1,6,0,0,0,2,2
2023/2/12 5:20,1,6,0,0,1,1,2
2023/2/12 5:30,1,6,0,0,0,1,1
2023/2/12 5:40,1,6,0,0,1,2,3
2023/2/12 5:50,1,7,0,0,3,2,5
2023/2/12 6:00,1,7,0,0,6,1,7
2023/2/12 6:10,1,7,0,0,8,2,10
2023/2/12 6:20,1,7,0,0,6,0,6
2023/2/12 6:30,1,7,0,0,11,4,15
2023/2/12 6:40,1,7,0,0,9,2,11
2023/2/12 6:50,1,7,0,0,10,4,14
2023/2/12 7:00,1,7,0,0,13,1,14
2023/2/12 7:10,1,7,0,0,22,3,25
2023/2/12 7:20,1,7,0,0,36,1,37
2023/2/12 7:30,1,7,0,0,47,5,52
2023/2/12 7:40,1,7,0,0,57,3,60
2023/2/12 7:50,1,7,0,0,52,2,54
2023/2/12 8:00,1,7,0,0,48,4,52
2023/2/12 8:10,1,7,0,0,42,3,45
2023/2/12 8:20,1,7,0,0,28,0,28
2023/2/12 8:30,1,7,0,0,38,2,40
2023/2/12 8:40,1,7,0,0,25,5,30
2023/2/12 8:50,1,7,0,0,35,4,39
2023/2/12 9:00,1,7,0,0,32,3,35
2023/2/12 9:10,1,7,0,0,33,6,39
2023/2/12 9:20,1,7,0,0,36,7,43
2023/2/12 9:30,1,7,0,0,40,15,55
2023/2/12 9:40,1,7,0,0,36,15,51
2023/2/12 9:50,1,8,0,0,35,8,43
2023/2/12 10:00,1,8,0,0,33,17,50
2023/2/12 10:10,1,8,0,0,25,9,34
2023/2/12 10:20,1,8,0,0,21,11,32
2023/2/12 10:30,1,8,0,0,19,14,33
2023/2/12 10:40,1,8,0,0,20,14,34
2023/2/12 10:50,1,8,0,0,21,15,36
2023/2/12 11:00,1,8,0,0,13,21,34
2023/2/12 11:10,1,8,0,0,15,15,30
2023/2/12 11:20,1,8,0,0,10,20,30
2023/2/12 11:30,1,8,0,0,13,22,35
2023/2/12 11:40,1,8,0,0,9,24,33
2023/2/12 11:50,1,8,0,0,14,33,47
2023/2/12 12:00,1,8,0,0,12,29,41
2023/2/12 12:10,1,8,0,0,14,26,40
2023/2/12 12:20,1,8,0,0,12,29,41
2023/2/12 12:30,1,8,0,0,15,29,44
2023/2/12 12:40,1,8,0,0,13,36,49
2023/2/12 12:50,1,8,0,0,8,26,34
2023/2/12 13:00,1,8,0,0,9,24,33
2023/2/12 13:10,1,8,0,0,12,19,31
2023/2/12 13:20,1,8,0,0,17,15,32
2023/2/12 13:30,1,8,0,0,15,15,30
2023/2/12 13:40,1,8,0,0,24,16,40
2023/2/12 13:50,1,8,0,0,21,19,40
2023/2/12 14:00,1,8,0,0,21,18,39
2023/2/12 14:10,1,8,0,0,19,19,38
2023/2/12 14:20,1,8,0,0,18,14,32
2023/2/12 14:30,1,8,0,0,15,17,32
2023/2/12 14:40,1,8,0,0,16,16,32
2023/2/12 14:50,1,7,0,0,19,16,35
2023/2/12 15:00,1,7,0,0,19,12,31
2023/2/12 15:10,1,7,0,0,21,14,35
2023/2/12 15:20,1,7,0,0,21,14,35
2023/2/12 15:30,1,7,0,0,25,18,43
2023/2/12 15:40,1,7,0,0,26,20,46
2023/2/12 15:50,1,7,0,0,27,14,41
2023/2/12 16:00,1,7,0,0,21,17,38
2023/2/12 16:10,1,7,0,0,21,17,38
2023/2/12 16:20,1,7,0,0,27,14,41
2023/2/12 16:30,1,7,0,0,26,11,37
2023/2/12 16:40,1,7,0,0,31,10,41
2023/2/12 16:50,1,7,0,0,31,17,48
2023/2/12 17:00,1,6,0,0,36,20,56
2023/2/12 17:10,1,6,0,0,35,23,58
2023/2/12 17:20,1,6,0,0,41,19,60
2023/2/12 17:30,1,6,0,0,37,27,64
2023/2/12 17:40,1,6,0,0,39,33,72
2023/2/12 17:50,1,6,0,0,39,30,69
2023/2/12 18:00,1,6,0,0,51,34,85
2023/2/12 18:10,1,6,0,0,42,27,69
2023/2/12 18:20,1,6,0,0,47,24,71
2023/2/12 18:30,1,6,0,0,36,26,62
2023/2/12 18:40,1,6,0,0,35,25,60
2023/2/12 18:50,1,6,0,0,40,27,67
2023/2/12 19:00,1,6,0,0,36,20,56
2023/2/12 19:10,1,6,0,0,26,23,49
2023/2/12 19:20,1,6,0,0,27,19,46
2023/2/12 19:30,1,6,0,0,22,16,38
2023/2/12 19:40,1,6,0,0,23,20,43
2023/2/12 19:50,1,6,0,0,24,15,39
2023/2/12 20:00,1,5,0,0,24,23,47
2023/2/12 20:10,1,5,0,0,17,20,37
2023/2/12 20:20,1,5,0,0,15,22,37
2023/2/12 20:30,1,5,0,0,16,31,47
2023/2/12 20:40,1,5,0,0,17,32,49
2023/2/12 20:50,1,5,0,0,15,35,50
2023/2/12 21:00,1,5,0,0,13,31,44
2023/2/12 21:10,1,5,0,0,17,25,42
2023/2/12 21:20,1,5,0,0,9,24,33
2023/2/12 21:30,1,5,0,0,9,25,34
2023/2/12 21:40,1,5,0,0,9,43,52
2023/2/12 21:50,1,5,0,0,7,43,50
2023/2/12 22:00,1,5,0,0,7,31,38
2023/2/12 22:10,1,5,0,0,3,35,38
2023/2/12 22:20,1,5,0,0,3,30,33
2023/2/12 22:30,1,5,0,0,3,15,18
2023/2/12 22:40,1,5,0,0,3,14,17
2023/2/12 22:50,1,5,0,0,3,11,14
2023/2/12 23:00,1,5,0,0,2,7,9
2023/2/12 23:10,1,4,0,0,3,3,6
2023/2/12 23:20,1,4,0,0,1,2,3
2023/2/12 23:30,1,4,0,0,1,0,1
2023/2/12 23:40,1,4,0,0,0,3,3
2023/2/12 23:50,1,4,0,0,0,1,1
2023/2/13 0:00,1,4,1,0,5,0,5
2023/2/13 0:10,1,4,1,0,3,1,4
2023/2/13 0:20,1,4,1,0,2,3,5
2023/2/13 0:30,1,4,1,0,2,1,3
2023/2/13 0:40,1,4,1,0,2,2,4
2023/2/13 0:50,1,4,1,0,2,1,3
2023/2/13 1:00,1,4,1,0,0,0,0
2023/2/13 1:10,1,3,1,0,2,1,3
2023/2/13 1:20,1,3,1,0,1,1,2
2023/2/13 1:30,1,3,1,0,2,1,3
2023/2/13 1:40,1,3,1,0,1,2,3
2023/2/13 1:50,1,3,1,0,1,0,1
2023/2/13 2:00,1,3,1,0,1,2,3
2023/2/13 2:10,1,3,1,0,2,1,3
2023/2/13 2:20,1,3,1,0,1,2,3
2023/2/13 2:30,1,3,1,0,2,1,3
2023/2/13 2:40,1,3,1,0,0,1,1
2023/2/13 2:50,1,3,1,0,1,1,2
2023/2/13 3:00,1,3,1,0,1,2,3
2023/2/13 3:10,1,3,1,0,0,2,2
2023/2/13 3:20,1,3,1,0,2,1,3
2023/2/13 3:30,1,3,1,0,1,0,1
2023/2/13 3:40,1,3,1,0,2,1,3
2023/2/13 3:50,1,3,1,0,0,0,0
2023/2/13 4:00,1,3,1,0,1,1,2
2023/2/13 4:10,1,3,1,0,2,2,4
2023/2/13 4:20,1,3,1,0,1,2,3
2023/2/13 4:30,1,3,1,0,0,1,1
2023/2/13 4:40,1,3,1,0,0,1,1
2023/2/13 4:50,1,3,1,0,0,0,0
2023/2/13 5:00,1,3,1,0,1,2,3
2023/2/13 5:10,1,3,1,0,0,0,0
2023/2/13 5:20,1,3,1,0,1,1,2
2023/2/13 5:30,1,3,1,0,2,2,4
2023/2/13 5:40,1,3,1,0,1,1,2
2023/2/13 5:50,1,3,1,0,5,1,6
2023/2/13 6:00,1,3,1,0,2,3,5
2023/2/13 6:10,1,3,1,0,2,1,3
2023/2/13 6:20,1,3,1,0,7,2,9
2023/2/13 6:30,1,3,1,0,4,4,8
2023/2/13 6:40,1,3,1,0,11,2,13
2023/2/13 6:50,1,3,1,0,35,0,35
2023/2/13 7:00,1,3,1,0,63,2,65
2023/2/13 7:10,1,3,1,0,93,2,95
2023/2/13 7:20,1,3,1,0,104,1,105
2023/2/13 7:30,1,3,1,0,306,0,306
2023/2/13 7:40,1,3,1,0,616,3,619
2023/2/13 7:50,1,4,1,0,606,6,612
2023/2/13 8:00,1,4,1,0,256,6,262
2023/2/13 8:10,1,4,1,0,157,8,165
2023/2/13 8:20,1,4,1,0,90,11,101
2023/2/13 8:30,1,4,1,0,85,11,96
2023/2/13 8:40,1,4,1,0,70,14,84
2023/2/13 8:50,1,4,1,0,76,10,86
2023/2/13 9:00,1,4,1,0,73,16,89
2023/2/13 9:10,1,4,1,0,97,19,116
2023/2/13 9:20,1,4,1,0,137,32,169
2023/2/13 9:30,1,4,1,0,229,43,272
2023/2/13 9:40,1,5,1,0,272,146,418
2023/2/13 9:50,1,5,1,0,180,159,339
2023/2/13 10:00,1,5,1,0,138,159,297
2023/2/13 10:10,1,5,1,0,79,110,189
2023/2/13 10:20,1,5,1,0,70,76,146
2023/2/13 10:30,1,5,1,0,67,52,119
2023/2/13 10:40,1,5,1,0,67,51,118
2023/2/13 10:50,1,5,1,0,68,45,113
2023/2/13 11:00,1,5,1,0,72,38,110
2023/2/13 11:10,1,5,1,0,55,35,90
2023/2/13 11:20,1,6,1,0,60,42,102
2023/2/13 11:30,1,6,1,0,72,78,150
2023/2/13 11:40,1,6,1,0,66,238,304
2023/2/13 11:50,1,6,1,0,59,316,375
2023/2/13 12:00,1,6,1,0,65,277,342
2023/2/13 12:10,1,6,1,0,57,170,227
2023/2/13 12:20,1,6,1,0,66,112,178
2023/2/13 12:30,1,6,1,0,65,78,143
2023/2/13 12:40,1,6,1,0,66,65,131
2023/2/13 12:50,1,6,1,0,61,56,117
2023/2/13 13:00,1,6,1,0,64,29,93
2023/2/13 13:10,1,6,1,0,54,29,83
2023/2/13 13:20,1,6,1,0,98,30,128
2023/2/13 13:30,1,6,1,0,171,37,208
2023/2/13 13:40,1,6,1,0,221,35,256
2023/2/13 13:50,1,6,1,0,241,37,278
2023/2/13 14:00,1,6,1,0,114,27,141
2023/2/13 14:10,1,6,1,0,101,39,140
2023/2/13 14:20,1,6,1,0,101,35,136
2023/2/13 14:30,1,6,1,0,97,43,140
2023/2/13 14:40,1,6,1,0,77,43,120
2023/2/13 14:50,1,6,1,0,69,39,108
2023/2/13 15:00,1,6,1,0,81,45,126
2023/2/13 15:10,1,5,1,0,77,39,116
2023/2/13 15:20,1,5,1,0,75,37,112
2023/2/13 15:30,1,5,1,0,92,63,155
2023/2/13 15:40,1,5,1,0,129,173,302
2023/2/13 15:50,1,5,1,0,140,197,337
2023/2/13 16:00,1,5,1,0,94,131,225
2023/2/13 16:10,1,5,1,0,95,129,224
2023/2/13 16:20,1,5,1,0,77,74,151
2023/2/13 16:30,1,5,1,0,84,64,148
2023/2/13 16:40,1,5,1,0,71,55,126
2023/2/13 16:50,1,5,1,0,68,59,127
2023/2/13 17:00,1,4,1,0,73,50,123
2023/2/13 17:10,1,4,1,0,65,63,128
2023/2/13 17:20,1,4,1,0,88,57,145
2023/2/13 17:30,1,4,1,0,80,80,160
2023/2/13 17:40,1,4,1,0,79,269,348
2023/2/13 17:50,1,4,1,0,94,222,316
2023/2/13 18:00,1,4,1,0,94,207,301
2023/2/13 18:10,1,4,1,0,97,146,243
2023/2/13 18:20,1,4,1,0,95,85,180
2023/2/13 18:30,1,4,1,0,107,91,198
2023/2/13 18:40,1,4,1,0,175,63,238
2023/2/13 18:50,1,4,1,0,189,60,249
2023/2/13 19:00,1,4,1,0,130,61,191
2023/2/13 19:10,1,4,1,0,110,64,174
2023/2/13 19:20,1,4,1,0,99,55,154
2023/2/13 19:30,1,3,1,0,97,56,153
2023/2/13 19:40,1,3,1,0,96,54,150
2023/2/13 19:50,1,3,1,0,88,61,149
2023/2/13 20:00,1,3,1,0,77,58,135
2023/2/13 20:10,1,3,1,0,90,57,147
2023/2/13 20:20,1,3,1,0,78,71,149
2023/2/13 20:30,1,3,1,0,72,101,173
2023/2/13 20:40,1,3,1,0,58,201,259
2023/2/13 20:50,1,3,1,0,57,231,288
2023/2/13 21:00,1,3,1,0,54,163,217
2023/2/13 21:10,1,3,1,0,45,144,189
2023/2/13 21:20,1,3,1,0,33,118,151
2023/2/13 21:30,1,2,1,0,26,65,91
2023/2/13 21:40,1,2,1,0,19,74,93
2023/2/13 21:50,1,2,1,0,15,87,102
2023/2/13 22:00,1,2,1,0,17,81,98
2023/2/13 22:10,1,2,1,0,14,79,93
2023/2/13 22:20,1,2,1,0,15,49,64
2023/2/13 22:30,1,2,1,0,15,37,52
2023/2/13 22:40,1,2,1,0,12,23,35
2023/2/13 22:50,1,2,1,0,12,11,23
2023/2/13 23:00,1,2,1,0,11,14,25
2023/2/13 23:10,1,2,1,0,8,12,20
2023/2/13 23:20,1,2,1,0,7,9,16
2023/2/13 23:30,1,1,1,0,1,9,10
2023/2/13 23:40,1,1,1,0,2,10,12
2023/2/13 23:50,1,1,1,0,1,5,6
2023/2/14 0:00,1,1,1,0,3,0,3
2023/2/14 0:10,1,1,1,0,3,0,3
2023/2/14 0:20,1,1,1,0,2,1,3
2023/2/14 0:30,1,1,1,0,1,1,2
2023/2/14 0:40,1,1,1,0,2,0,2
2023/2/14 0:50,1,1,1,0,1,2,3
2023/2/14 1:00,1,1,1,0,1,1,2
2023/2/14 1:10,1,1,1,0,1,1,2
2023/2/14 1:20,1,1,1,0,1,1,2
2023/2/14 1:30,1,1,1,0,1,1,2
2023/2/14 1:40,1,1,1,0,0,1,1
2023/2/14 1:50,1,1,1,0,2,2,4
2023/2/14 2:00,1,0,1,0,2,1,3
2023/2/14 2:10,1,0,1,0,1,2,3
2023/2/14 2:20,1,0,1,0,0,2,2
2023/2/14 2:30,1,0,1,0,1,0,1
2023/2/14 2:40,1,0,1,0,0,2,2
2023/2/14 2:50,1,0,1,0,1,1,2
2023/2/14 3:00,1,0,1,0,2,1,3
2023/2/14 3:10,1,0,1,0,0,0,0
2023/2/14 3:20,1,0,1,0,2,1,3
2023/2/14 3:30,1,0,1,0,1,0,1
2023/2/14 3:40,1,0,1,0,2,0,2
2023/2/14 3:50,1,0,1,0,0,2,2
2023/2/14 4:00,1,0,1,0,0,0,0
2023/2/14 4:10,1,0,1,0,0,2,2
2023/2/14 4:20,1,0,1,0,1,2,3
2023/2/14 4:30,1,0,1,0,2,1,3
2023/2/14 4:40,1,0,1,0,1,0,1
2023/2/14 4:50,1,0,1,0,0,0,0
2023/2/14 5:00,1,0,1,0,1,1,2
2023/2/14 5:10,1,0,1,0,1,2,3
2023/2/14 5:20,1,0,1,0,2,0,2
2023/2/14 5:30,1,0,1,0,2,2,4
2023/2/14 5:40,1,0,1,0,2,1,3
2023/2/14 5:50,1,0,1,0,3,0,3
2023/2/14 6:00,1,1,1,0,3,4,7
2023/2/14 6:10,1,1,1,0,2,1,3
2023/2/14 6:20,1,1,1,0,6,3,9
2023/2/14 6:30,1,1,1,0,7,4,11
2023/2/14 6:40,1,1,1,0,14,2,16
2023/2/14 6:50,1,1,1,0,41,0,41
2023/2/14 7:00,1,2,1,0,59,2,61
2023/2/14 7:10,1,2,1,0,101,0,101
2023/2/14 7:20,1,2,1,0,106,3,109
2023/2/14 7:30,1,2,1,0,282,2,284
2023/2/14 7:40,1,2,1,0,540,5,545
2023/2/14 7:50,1,2,1,0,583,3,586
2023/2/14 8:00,1,2,1,0,292,5,297
2023/2/14 8:10,1,2,1,0,142,12,154
2023/2/14 8:20,1,2,1,0,85,8,93
2023/2/14 8:30,1,2,1,0,92,11,103
2023/2/14 8:40,1,3,1,0,72,13,85
2023/2/14 8:50,1,3,1,0,65,11,76
2023/2/14 9:00,1,3,1,0,82,15,97
2023/2/14 9:10,1,3,1,0,77,16,93
2023/2/14 9:20,1,3,1,0,135,27,162
2023/2/14 9:30,1,3,1,0,228,38,266
2023/2/14 9:40,1,3,1,0,256,123,379
2023/2/14 9:50,1,3,1,0,217,156,373
2023/2/14 10:00,1,3,1,0,126,141,267
2023/2/14 10:10,1,3,1,0,79,108,187
2023/2/14 10:20,1,4,1,0,87,79,166
2023/2/14 10:30,1,4,1,0,57,45,102
2023/2/14 10:40,1,4,1,0,68,47,115
2023/2/14 10:50,1,4,1,0,74,40,114
2023/2/14 11:00,1,4,1,0,74,37,111
2023/2/14 11:10,1,4,1,0,62,41,103
2023/2/14 11:20,1,4,1,0,67,47,114
2023/2/14 11:30,1,4,1,0,63,76,139
2023/2/14 11:40,1,4,1,0,80,246,326
2023/2/14 11:50,1,4,1,0,73,311,384
2023/2/14 12:00,1,4,1,0,58,231,289
2023/2/14 12:10,1,4,1,0,52,202,254
2023/2/14 12:20,1,4,1,0,53,106,159
2023/2/14 12:30,1,4,1,0,62,97,159
2023/2/14 12:40,1,4,1,0,63,62,125
2023/2/14 12:50,1,4,1,0,62,55,117
2023/2/14 13:00,1,5,1,0,66,29,95
2023/2/14 13:10,1,5,1,0,64,32,96
2023/2/14 13:20,1,5,1,0,79,34,113
2023/2/14 13:30,1,5,1,0,159,37,196
2023/2/14 13:40,1,5,1,0,237,36,273
2023/2/14 13:50,1,5,1,0,274,41,315
2023/2/14 14:00,1,5,1,0,143,30,173
2023/2/14 14:10,1,5,1,0,118,45,163
2023/2/14 14:20,1,5,1,0,108,41,149
2023/2/14 14:30,1,5,1,0,86,47,133
2023/2/14 14:40,1,5,1,0,75,43,118
2023/2/14 14:50,1,5,1,0,74,45,119
2023/2/14 15:00,1,5,1,0,81,44,125
2023/2/14 15:10,1,5,1,0,76,40,116
2023/2/14 15:20,1,6,1,0,73,38,111
2023/2/14 15:30,1,6,1,0,93,58,151
2023/2/14 15:40,1,6,1,0,121,157,278
2023/2/14 15:50,1,6,1,0,176,231,407
2023/2/14 16:00,1,6,1,0,97,134,231
2023/2/14 16:10,1,6,1,0,89,119,208
2023/2/14 16:20,1,6,1,0,68,82,150
2023/2/14 16:30,1,6,1,0,73,73,146
2023/2/14 16:40,1,6,1,0,62,53,115
2023/2/14 16:50,1,6,1,0,64,66,130
2023/2/14 17:00,1,6,1,0,78,62,140
2023/2/14 17:10,1,6,1,0,72,54,126
2023/2/14 17:20,1,6,1,0,88,50,138
2023/2/14 17:30,1,6,1,0,76,81,157
2023/2/14 17:40,1,6,1,0,80,245,325
2023/2/14 17:50,1,6,1,0,89,237,326
2023/2/14 18:00,1,6,1,0,100,213,313
2023/2/14 18:10,1,6,1,0,77,143,220
2023/2/14 18:20,1,6,1,0,94,98,192
2023/2/14 18:30,1,6,1,0,125,77,202
2023/2/14 18:40,1,6,1,0,182,80,262
2023/2/14 18:50,1,6,1,0,163,75,238
2023/2/14 19:00,1,5,1,0,118,62,180
2023/2/14 19:10,1,5,1,0,118,57,175
2023/2/14 19:20,1,5,1,0,86,55,141
2023/2/14 19:30,1,5,1,0,99,63,162
2023/2/14 19:40,1,5,1,0,94,64,158
2023/2/14 19:50,1,5,1,0,88,59,147
2023/2/14 20:00,1,5,1,0,80,70,150
2023/2/14 20:10,1,5,1,0,82,56,138
2023/2/14 20:20,1,5,1,0,71,68,139
2023/2/14 20:30,1,5,1,0,73,107,180
2023/2/14 20:40,1,5,1,0,69,192,261
2023/2/14 20:50,1,5,1,0,50,241,291
2023/2/14 21:00,1,4,1,0,42,150,192
2023/2/14 21:10,1,4,1,0,44,145,189
2023/2/14 21:20,1,4,1,0,27,98,125
2023/2/14 21:30,1,4,1,0,21,67,88
2023/2/14 21:40,1,4,1,0,19,82,101
2023/2/14 21:50,1,4,1,0,18,81,99
2023/2/14 22:00,1,4,1,0,18,83,101
2023/2/14 22:10,1,4,1,0,17,75,92
2023/2/14 22:20,1,4,1,0,14,45,59
2023/2/14 22:30,1,3,1,0,14,31,45
2023/2/14 22:40,1,3,1,0,9,23,32
2023/2/14 22:50,1,3,1,0,8,12,20
2023/2/14 23:00,1,3,1,0,8,12,20
2023/2/14 23:10,1,3,1,0,7,14,21
2023/2/14 23:20,1,3,1,0,6,12,18
2023/2/14 23:30,1,3,1,0,2,10,12
2023/2/14 23:40,1,3,1,0,3,8,11
2023/2/14 23:50,1,3,1,0,1,3,4
2023/2/15 0:00,1,3,1,0,5,1,6
2023/2/15 0:10,1,2,1,0,4,0,4
2023/2/15 0:20,1,2,1,0,4,1,5
2023/2/15 0:30,1,2,1,0,2,0,2
2023/2/15 0:40,1,2,1,0,2,0,2
2023/2/15 0:50,1,2,1,0,2,0,2
2023/2/15 1:00,1,2,1,0,0,1,1
2023/2/15 1:10,1,2,1,0,2,0,2
2023/2/15 1:20,1,2,1,0,0,2,2
2023/2/15 1:30,1,2,1,0,2,0,2
2023/2/15 1:40,1,2,1,0,2,1,3
2023/2/15 1:50,1,2,1,0,1,2,3
2023/2/15 2:00,1,2,1,0,1,1,2
2023/2/15 2:10,1,2,1,0,2,2,4
2023/2/15 2:20,1,1,1,0,2,0,2
2023/2/15 2:30,1,1,1,0,1,1,2
2023/2/15 2:40,1,1,1,0,2,2,4
2023/2/15 2:50,1,1,1,0,2,1,3
2023/2/15 3:00,1,1,1,0,2,2,4
2023/2/15 3:10,1,1,1,0,0,1,1
2023/2/15 3:20,1,1,1,0,0,0,0
2023/2/15 3:30,1,1,1,0,1,1,2
2023/2/15 3:40,1,1,1,0,2,1,3
2023/2/15 3:50,1,1,1,0,2,0,2
2023/2/15 4:00,1,1,1,0,2,2,4
2023/2/15 4:10,1,1,1,0,0,0,0
2023/2/15 4:20,1,1,1,0,0,1,1
2023/2/15 4:30,1,1,1,0,2,2,4
2023/2/15 4:40,1,1,1,0,1,0,1
2023/2/15 4:50,1,1,1,0,0,1,1
2023/2/15 5:00,1,1,1,0,2,1,3
2023/2/15 5:10,1,1,1,0,1,2,3
2023/2/15 5:20,1,1,1,0,1,2,3
2023/2/15 5:30,1,1,1,0,2,2,4
2023/2/15 5:40,1,1,1,0,1,2,3
2023/2/15 5:50,1,2,1,0,5,2,7
2023/2/15 6:00,1,2,1,0,2,2,4
2023/2/15 6:10,1,2,1,0,3,3,6
2023/2/15 6:20,1,3,1,0,7,1,8
2023/2/15 6:30,1,3,1,0,7,2,9
2023/2/15 6:40,1,3,1,0,10,0,10
2023/2/15 6:50,1,3,1,0,34,0,34
2023/2/15 7:00,1,3,1,0,65,2,67
2023/2/15 7:10,1,3,1,0,101,2,103
2023/2/15 7:20,1,3,1,0,100,1,101
2023/2/15 7:30,1,3,1,0,343,1,344
2023/2/15 7:40,1,3,1,0,611,5,616
2023/2/15 7:50,1,3,1,0,565,4,569
2023/2/15 8:00,1,4,1,0,277,6,283
2023/2/15 8:10,1,4,1,0,138,12,150
2023/2/15 8:20,1,4,1,0,84,10,94
2023/2/15 8:30,1,4,1,0,88,13,101
2023/2/15 8:40,1,4,1,0,88,16,104
2023/2/15 8:50,1,4,1,0,84,12,96
2023/2/15 9:00,1,5,1,0,77,15,92
2023/2/15 9:10,1,5,1,0,86,17,103
2023/2/15 9:20,1,5,1,0,134,26,160
2023/2/15 9:30,1,5,1,0,212,45,257
2023/2/15 9:40,1,5,1,0,249,137,386
2023/2/15 9:50,1,6,1,0,183,186,369
2023/2/15 10:00,1,6,1,0,151,137,288
2023/2/15 10:10,1,6,1,0,90,94,184
2023/2/15 10:20,1,6,1,0,84,77,161
2023/2/15 10:30,1,6,1,0,68,55,123
2023/2/15 10:40,1,6,1,0,63,42,105
2023/2/15 10:50,1,7,1,0,63,41,104
2023/2/15 11:00,1,7,1,0,74,39,113
2023/2/15 11:10,1,7,1,0,56,40,96
2023/2/15 11:20,1,7,1,0,64,48,112
2023/2/15 11:30,1,7,1,0,61,62,123
2023/2/15 11:40,1,7,1,0,77,233,310
2023/2/15 11:50,1,7,1,0,76,262,338
2023/2/15 12:00,1,7,1,0,59,284,343
2023/2/15 12:10,1,8,1,0,57,165,222
2023/2/15 12:20,1,8,1,0,53,107,160
2023/2/15 12:30,1,8,1,0,44,80,124
2023/2/15 12:40,1,8,1,0,25,69,94
2023/2/15 12:50,1,8,1,0,18,52,70
2023/2/15 13:00,1,8,1,0,18,27,45
2023/2/15 13:10,1,9,1,0,13,20,33
2023/2/15 13:20,1,9,1,0,16,15,31
2023/2/15 13:30,1,9,1,0,17,15,32
2023/2/15 13:40,1,9,1,0,29,24,53
2023/2/15 13:50,1,9,1,0,28,26,54
2023/2/15 14:00,1,9,1,0,28,22,50
2023/2/15 14:10,1,9,1,0,22,23,45
2023/2/15 14:20,1,9,1,0,18,20,38
2023/2/15 14:30,1,9,1,0,20,21,41
2023/2/15 14:40,1,9,1,0,21,16,37
2023/2/15 14:50,1,9,1,0,20,14,34
2023/2/15 15:00,1,9,1,0,24,11,35
2023/2/15 15:10,1,10,1,0,29,16,45
2023/2/15 15:20,1,10,1,0,27,18,45
2023/2/15 15:30,1,10,1,0,29,19,48
2023/2/15 15:40,1,10,1,0,29,23,52
2023/2/15 15:50,1,10,1,0,34,17,51
2023/2/15 16:00,1,10,1,0,29,18,47
2023/2/15 16:10,1,11,1,0,30,18,48
2023/2/15 16:20,1,11,1,0,33,17,50
2023/2/15 16:30,1,11,1,0,37,14,51
2023/2/15 16:40,1,11,1,0,38,14,52
2023/2/15 16:50,1,11,1,0,45,18,63
2023/2/15 17:00,1,11,1,0,41,21,62
2023/2/15 17:10,1,11,1,0,39,26,65
2023/2/15 17:20,1,12,1,0,49,24,73
2023/2/15 17:30,1,12,1,0,47,29,76
2023/2/15 17:40,1,12,1,0,36,32,68
2023/2/15 17:50,1,12,1,0,45,45,90
2023/2/15 18:00,1,12,1,0,60,38,98
2023/2/15 18:10,1,12,1,0,57,31,88
2023/2/15 18:20,1,12,1,0,51,34,85
2023/2/15 18:30,1,12,1,0,50,30,80
2023/2/15 18:40,1,12,1,0,52,31,83
2023/2/15 18:50,1,12,1,0,51,36,87
2023/2/15 19:00,1,11,1,0,35,29,64
2023/2/15 19:10,1,11,1,0,37,26,63
2023/2/15 19:20,1,11,1,0,27,24,51
2023/2/15 19:30,1,11,1,0,29,20,49
2023/2/15 19:40,1,11,1,0,30,26,56
2023/2/15 19:50,1,11,1,0,27,21,48
2023/2/15 20:00,1,10,1,0,26,29,55
2023/2/15 20:10,1,10,1,0,23,22,45
2023/2/15 20:20,1,10,1,0,21,28,49
2023/2/15 20:30,1,10,1,0,22,36,58
2023/2/15 20:40,1,10,1,0,18,36,54
2023/2/15 20:50,1,10,1,0,18,37,55
2023/2/15 21:00,1,10,1,0,13,40,53
2023/2/15 21:10,1,9,1,0,19,34,53
2023/2/15 21:20,1,9,1,0,15,30,45
2023/2/15 21:30,1,9,1,0,12,27,39
2023/2/15 21:40,1,9,1,0,9,50,59
2023/2/15 21:50,1,9,1,0,11,50,61
2023/2/15 22:00,1,9,1,0,6,43,49
2023/2/15 22:10,1,9,1,0,3,42,45
2023/2/15 22:20,1,9,1,0,4,33,37
2023/2/15 22:30,1,8,1,0,3,20,23
2023/2/15 22:40,1,8,1,0,3,16,19
2023/2/15 22:50,1,8,1,0,3,10,13
2023/2/15 23:00,1,8,1,0,2,7,9
2023/2/15 23:10,1,7,1,0,1,7,8
2023/2/15 23:20,1,7,1,0,2,1,3
2023/2/15 23:30,1,7,1,0,2,0,2
2023/2/15 23:40,1,7,1,0,2,2,4
2023/2/15 23:50,1,7,1,0,2,1,3
2023/2/16 0:00,1,7,1,0,5,1,6
2023/2/16 0:10,1,7,1,0,3,0,3
2023/2/16 0:20,1,7,1,0,2,3,5
2023/2/16 0:30,1,7,1,0,1,1,2
2023/2/16 0:40,1,7,1,0,2,2,4
2023/2/16 0:50,1,6,1,0,0,0,0
2023/2/16 1:00,1,6,1,0,0,0,0
2023/2/16 1:10,1,6,1,0,2,2,4
2023/2/16 1:20,1,6,1,0,2,2,4
2023/2/16 1:30,1,6,1,0,0,0,0
2023/2/16 1:40,1,6,1,0,0,1,1
2023/2/16 1:50,1,6,1,0,0,1,1
2023/2/16 2:00,1,6,1,0,2,1,3
2023/2/16 2:10,1,5,1,0,0,0,0
2023/2/16 2:20,1,5,1,0,1,0,1
2023/2/16 2:30,1,5,1,0,1,2,3
2023/2/16 2:40,1,5,1,0,2,2,4
2023/2/16 2:50,1,5,1,0,2,0,2
2023/2/16 3:00,1,4,1,0,0,1,1
2023/2/16 3:10,1,4,1,0,2,0,2
2023/2/16 3:20,1,4,1,0,1,1,2
2023/2/16 3:30,1,4,1,0,2,1,3
2023/2/16 3:40,1,4,1,0,0,2,2
2023/2/16 3:50,1,4,1,0,2,2,4
2023/2/16 4:00,1,4,1,0,1,2,3
2023/2/16 4:10,1,4,1,0,1,0,1
2023/2/16 4:20,1,4,1,0,1,2,3
2023/2/16 4:30,1,4,1,0,1,1,2
2023/2/16 4:40,1,4,1,0,2,0,2
2023/2/16 4:50,1,4,1,0,0,0,0
2023/2/16 5:00,1,4,1,0,1,2,3
2023/2/16 5:10,1,4,1,0,1,1,2
2023/2/16 5:20,1,4,1,0,2,1,3
2023/2/16 5:30,1,4,1,0,1,0,1
2023/2/16 5:40,1,4,1,0,0,2,2
2023/2/16 5:50,1,4,1,0,3,1,4
2023/2/16 6:00,1,4,1,0,4,2,6
2023/2/16 6:10,1,4,1,0,3,1,4
2023/2/16 6:20,1,4,1,0,4,2,6
2023/2/16 6:30,1,4,1,0,4,2,6
2023/2/16 6:40,1,4,1,0,11,0,11
2023/2/16 6:50,1,4,1,0,43,1,44
2023/2/16 7:00,1,5,1,0,58,3,61
2023/2/16 7:10,1,5,1,0,95,0,95
2023/2/16 7:20,1,5,1,0,121,3,124
2023/2/16 7:30,1,5,1,0,292,0,292
2023/2/16 7:40,1,5,1,0,555,3,558
2023/2/16 7:50,1,5,1,0,589,5,594
2023/2/16 8:00,1,5,1,0,300,7,307
2023/2/16 8:10,1,5,1,0,144,12,156
2023/2/16 8:20,1,5,1,0,94,8,102
2023/2/16 8:30,1,5,1,0,78,15,93
2023/2/16 8:40,1,5,1,0,71,13,84
2023/2/16 8:50,1,5,1,0,70,12,82
2023/2/16 9:00,1,6,1,0,72,16,88
2023/2/16 9:10,1,6,1,0,77,17,94
2023/2/16 9:20,1,6,1,0,151,25,176
2023/2/16 9:30,1,6,1,0,213,41,254
2023/2/16 9:40,1,6,1,0,251,115,366
2023/2/16 9:50,1,6,1,0,192,195,387
2023/2/16 10:00,1,6,1,0,124,167,291
2023/2/16 10:10,1,6,1,0,74,107,181
2023/2/16 10:20,1,6,1,0,70,77,147
2023/2/16 10:30,1,6,1,0,62,53,115
2023/2/16 10:40,1,6,1,0,56,43,99
2023/2/16 10:50,1,6,1,0,69,42,111
2023/2/16 11:00,1,6,1,0,70,38,108
2023/2/16 11:10,1,7,1,0,56,42,98
2023/2/16 11:20,1,7,1,0,54,49,103
2023/2/16 11:30,1,7,1,0,71,66,137
2023/2/16 11:40,1,7,1,0,66,223,289
2023/2/16 11:50,1,7,1,0,65,268,333
2023/2/16 12:00,1,7,1,0,65,246,311
2023/2/16 12:10,1,7,1,0,62,197,259
2023/2/16 12:20,1,7,1,0,62,129,191
2023/2/16 12:30,1,7,1,0,57,87,144
2023/2/16 12:40,1,7,1,0,55,69,124
2023/2/16 12:50,1,7,1,0,67,56,123
2023/2/16 13:00,1,7,1,0,55,30,85
2023/2/16 13:10,1,7,1,0,58,31,89
2023/2/16 13:20,1,7,1,0,91,29,120
2023/2/16 13:30,1,7,1,0,160,38,198
2023/2/16 13:40,1,7,1,0,269,35,304
2023/2/16 13:50,1,8,1,0,268,36,304
2023/2/16 14:00,1,8,1,0,123,35,158
2023/2/16 14:10,1,8,1,0,109,43,152
2023/2/16 14:20,1,8,1,0,112,38,150
2023/2/16 14:30,1,8,1,0,98,44,142
2023/2/16 14:40,1,8,1,0,78,39,117
2023/2/16 14:50,1,8,1,0,70,38,108
2023/2/16 15:00,1,8,1,0,67,45,112
2023/2/16 15:10,1,8,1,0,68,39,107
2023/2/16 15:20,1,8,1,0,79,38,117
2023/2/16 15:30,1,8,1,0,87,59,146
2023/2/16 15:40,1,8,1,0,143,195,338
2023/2/16 15:50,1,8,1,0,155,191,346
2023/2/16 16:00,1,9,1,0,105,136,241
2023/2/16 16:10,1,9,1,0,89,124,213
2023/2/16 16:20,1,9,1,0,85,90,175
2023/2/16 16:30,1,9,1,0,73,69,142
2023/2/16 16:40,1,9,1,0,65,66,131
2023/2/16 16:50,1,9,1,0,73,69,142
2023/2/16 17:00,1,9,1,0,72,55,127
2023/2/16 17:10,1,9,1,0,77,50,127
2023/2/16 17:20,1,9,1,0,79,57,136
2023/2/16 17:30,1,9,1,0,74,75,149
2023/2/16 17:40,1,9,1,0,81,231,312
2023/2/16 17:50,1,9,1,0,91,272,363
2023/2/16 18:00,1,9,1,0,87,212,299
2023/2/16 18:10,1,9,1,0,77,133,210
2023/2/16 18:20,1,9,1,0,107,101,208
2023/2/16 18:30,1,9,1,0,118,84,202
2023/2/16 18:40,1,10,1,0,174,63,237
2023/2/16 18:50,1,10,1,0,168,69,237
2023/2/16 19:00,1,10,1,0,132,64,196
2023/2/16 19:10,1,10,1,0,127,60,187
2023/2/16 19:20,1,10,1,0,92,64,156
2023/2/16 19:30,1,10,1,0,94,54,148
2023/2/16 19:40,1,10,1,0,95,54,149
2023/2/16 19:50,1,10,1,0,78,65,143
2023/2/16 20:00,1,10,1,0,90,64,154
2023/2/16 20:10,1,10,1,0,77,67,144
2023/2/16 20:20,1,10,1,0,67,63,130
2023/2/16 20:30,1,10,1,0,58,91,149
2023/2/16 20:40,1,10,1,0,58,207,265
2023/2/16 20:50,1,10,1,0,50,228,278
2023/2/16 21:00,1,10,1,0,50,143,193
2023/2/16 21:10,1,11,1,0,55,130,185
2023/2/16 21:20,1,11,1,0,29,102,131
2023/2/16 21:30,1,11,1,0,25,66,91
2023/2/16 21:40,1,11,1,0,21,79,100
2023/2/16 21:50,1,11,1,0,20,74,94
2023/2/16 22:00,1,11,1,0,14,78,92
2023/2/16 22:10,1,11,1,0,15,85,100
2023/2/16 22:20,1,11,1,0,17,44,61
2023/2/16 22:30,1,11,1,0,16,31,47
2023/2/16 22:40,1,11,1,0,13,21,34
2023/2/16 22:50,1,11,1,0,9,11,20
2023/2/16 23:00,1,11,1,0,10,10,20
2023/2/16 23:10,1,11,1,0,5,14,19
2023/2/16 23:20,1,11,1,0,6,12,18
2023/2/16 23:30,1,11,1,0,3,8,11
2023/2/16 23:40,1,11,1,0,1,11,12
2023/2/16 23:50,1,11,1,0,2,5,7
2023/2/17 0:00,1,11,1,0,3,2,5
2023/2/17 0:10,1,11,1,0,2,2,4
2023/2/17 0:20,1,11,1,0,4,3,7
2023/2/17 0:30,1,11,1,0,2,1,3
2023/2/17 0:40,1,11,1,0,3,0,3
2023/2/17 0:50,1,11,1,0,0,2,2
2023/2/17 1:00,1,11,1,0,0,2,2
2023/2/17 1:10,1,11,1,0,0,1,1
2023/2/17 1:20,1,11,1,0,0,1,1
2023/2/17 1:30,1,11,1,0,2,0,2
2023/2/17 1:40,1,11,1,0,2,2,4
2023/2/17 1:50,1,11,1,0,1,1,2
2023/2/17 2:00,1,11,1,0,1,0,1
2023/2/17 2:10,1,10,1,0,1,2,3
2023/2/17 2:20,1,10,1,0,1,1,2
2023/2/17 2:30,1,10,1,0,0,2,2
2023/2/17 2:40,1,10,1,0,1,0,1
2023/2/17 2:50,1,10,1,0,1,0,1
2023/2/17 3:00,1,10,1,0,0,0,0
2023/2/17 3:10,1,10,1,0,0,1,1
2023/2/17 3:20,1,10,1,0,1,2,3
2023/2/17 3:30,1,10,1,0,0,1,1
2023/2/17 3:40,1,10,1,0,0,1,1
2023/2/17 3:50,1,10,1,0,0,0,0
2023/2/17 4:00,1,10,1,0,0,2,2
2023/2/17 4:10,1,10,1,0,1,2,3
2023/2/17 4:20,1,10,1,0,2,0,2
2023/2/17 4:30,1,10,1,0,0,2,2
2023/2/17 4:40,1,10,1,0,1,0,1
2023/2/17 4:50,1,10,1,0,1,1,2
2023/2/17 5:00,1,10,1,0,1,0,1
2023/2/17 5:10,1,10,1,0,1,1,2
2023/2/17 5:20,1,10,1,0,0,2,2
2023/2/17 5:30,1,10,1,0,1,2,3
2023/2/17 5:40,1,10,1,0,2,1,3
2023/2/17 5:50,1,10,1,0,3,0,3
2023/2/17 6:00,1,10,1,0,4,4,8
2023/2/17 6:10,1,10,1,0,4,2,6
2023/2/17 6:20,1,10,1,0,6,1,7
2023/2/17 6:30,1,10,1,0,5,3,8
2023/2/17 6:40,1,10,1,0,11,2,13
2023/2/17 6:50,1,10,1,0,37,0,37
2023/2/17 7:00,1,10,1,0,61,2,63
2023/2/17 7:10,1,10,1,0,90,1,91
2023/2/17 7:20,1,10,1,0,108,3,111
2023/2/17 7:30,1,10,1,0,334,0,334
2023/2/17 7:40,1,10,1,0,523,3,526
2023/2/17 7:50,1,10,1,0,624,6,630
2023/2/17 8:00,1,10,1,0,315,7,322
2023/2/17 8:10,1,10,1,0,154,12,166
2023/2/17 8:20,1,10,1,0,87,10,97
2023/2/17 8:30,1,10,1,0,82,12,94
2023/2/17 8:40,1,10,1,0,72,16,88
2023/2/17 8:50,1,10,1,0,78,14,92
2023/2/17 9:00,1,10,1,0,73,16,89
2023/2/17 9:10,1,10,1,0,88,20,108
2023/2/17 9:20,1,10,1,0,150,25,175
2023/2/17 9:30,1,10,1,0,218,37,255
2023/2/17 9:40,1,10,1,0,252,128,380
2023/2/17 9:50,1,11,1,0,215,188,403
2023/2/17 10:00,1,11,1,0,134,153,287
2023/2/17 10:10,1,11,1,0,86,98,184
2023/2/17 10:20,1,11,1,0,67,71,138
2023/2/17 10:30,1,11,1,0,57,45,102
2023/2/17 10:40,1,11,1,0,65,49,114
2023/2/17 10:50,1,11,1,0,76,36,112
2023/2/17 11:00,1,11,1,0,75,38,113
2023/2/17 11:10,1,11,1,0,67,40,107
2023/2/17 11:20,1,11,1,0,64,46,110
2023/2/17 11:30,1,11,1,0,63,64,127
2023/2/17 11:40,1,11,1,0,69,208,277
2023/2/17 11:50,1,11,1,0,59,302,361
2023/2/17 12:00,1,11,1,0,59,286,345
2023/2/17 12:10,1,11,1,0,51,195,246
2023/2/17 12:20,1,11,1,0,63,114,177
2023/2/17 12:30,1,11,1,0,55,79,134
2023/2/17 12:40,1,11,1,0,62,59,121
2023/2/17 12:50,1,11,1,0,65,56,121
2023/2/17 13:00,1,11,1,0,65,32,97
2023/2/17 13:10,1,11,1,0,67,30,97
2023/2/17 13:20,1,11,1,0,86,30,116
2023/2/17 13:30,1,11,1,0,180,39,219
2023/2/17 13:40,1,11,1,0,220,39,259
2023/2/17 13:50,1,11,1,0,249,39,288
2023/2/17 14:00,1,11,1,0,125,29,154
2023/2/17 14:10,1,11,1,0,98,38,136
2023/2/17 14:20,1,11,1,0,99,43,142
2023/2/17 14:30,1,11,1,0,82,44,126
2023/2/17 14:40,1,11,1,0,89,41,130
2023/2/17 14:50,1,11,1,0,73,38,111
2023/2/17 15:00,1,11,1,0,81,39,120
2023/2/17 15:10,1,11,1,0,65,46,111
2023/2/17 15:20,1,11,1,0,84,43,127
2023/2/17 15:30,1,11,1,0,92,73,165
2023/2/17 15:40,1,11,1,0,149,186,335
2023/2/17 15:50,1,11,1,0,168,231,399
2023/2/17 16:00,1,11,1,0,114,149,263
2023/2/17 16:10,1,11,1,0,86,118,204
2023/2/17 16:20,1,11,1,0,71,84,155
2023/2/17 16:30,1,11,1,0,69,63,132
2023/2/17 16:40,1,11,1,0,66,52,118
2023/2/17 16:50,1,11,1,0,81,55,136
2023/2/17 17:00,1,11,1,0,66,51,117
2023/2/17 17:10,1,11,1,0,75,53,128
2023/2/17 17:20,1,11,1,0,82,57,139
2023/2/17 17:30,1,11,1,0,72,76,148
2023/2/17 17:40,1,11,1,0,81,266,347
2023/2/17 17:50,1,11,1,0,105,253,358
2023/2/17 18:00,1,11,1,0,97,192,289
2023/2/17 18:10,1,11,1,0,87,129,216
2023/2/17 18:20,1,11,1,0,93,85,178
2023/2/17 18:30,1,11,1,0,108,83,191
2023/2/17 18:40,1,10,1,0,157,75,232
2023/2/17 18:50,1,10,1,0,177,69,246
2023/2/17 19:00,1,10,1,0,130,64,194
2023/2/17 19:10,1,10,1,0,120,63,183
2023/2/17 19:20,1,10,1,0,109,54,163
2023/2/17 19:30,1,10,1,0,82,68,150
2023/2/17 19:40,1,10,1,0,79,53,132
2023/2/17 19:50,1,10,1,0,84,56,140
2023/2/17 20:00,1,10,1,0,85,61,146
2023/2/17 20:10,1,10,1,0,71,67,138
2023/2/17 20:20,1,10,1,0,83,61,144
2023/2/17 20:30,1,10,1,0,65,94,159
2023/2/17 20:40,1,10,1,0,69,178,247
2023/2/17 20:50,1,10,1,0,60,224,284
2023/2/17 21:00,1,10,1,0,48,166,214
2023/2/17 21:10,1,10,1,0,57,129,186
2023/2/17 21:20,1,10,1,0,32,110,142
2023/2/17 21:30,1,10,1,0,21,78,99
2023/2/17 21:40,1,10,1,0,20,76,96
2023/2/17 21:50,1,10,1,0,16,86,102
2023/2/17 22:00,1,10,1,0,16,95,111
2023/2/17 22:10,1,10,1,0,16,65,81
2023/2/17 22:20,1,10,1,0,18,47,65
2023/2/17 22:30,1,10,1,0,13,39,52
2023/2/17 22:40,1,10,1,0,10,21,31
2023/2/17 22:50,1,10,1,0,11,15,26
2023/2/17 23:00,1,10,1,0,9,10,19
2023/2/17 23:10,1,10,1,0,6,11,17
2023/2/17 23:20,1,10,1,0,4,9,13
2023/2/17 23:30,1,9,1,0,3,10,13
2023/2/17 23:40,1,9,1,0,1,9,10
2023/2/17 23:50,1,9,1,0,0,6,6
2023/2/18 0:00,1,9,0,0,2,2,4
2023/2/18 0:10,1,9,0,0,1,2,3
2023/2/18 0:20,1,9,0,0,0,1,1
2023/2/18 0:30,1,9,0,0,1,0,1
2023/2/18 0:40,1,9,0,0,0,2,2
2023/2/18 0:50,1,9,0,0,0,2,2
2023/2/18 1:00,1,9,0,0,2,1,3
2023/2/18 1:10,1,9,0,0,0,1,1
2023/2/18 1:20,1,9,0,0,2,1,3
2023/2/18 1:30,1,9,0,0,0,2,2
2023/2/18 1:40,1,9,0,0,0,0,0
2023/2/18 1:50,1,9,0,0,1,1,2
2023/2/18 2:00,1,9,0,0,1,0,1
2023/2/18 2:10,1,9,0,0,0,0,0
2023/2/18 2:20,1,9,0,0,0,0,0
2023/2/18 2:30,1,9,0,0,1,0,1
2023/2/18 2:40,1,9,0,0,1,0,1
2023/2/18 2:50,1,9,0,0,0,1,1
2023/2/18 3:00,1,9,0,0,1,1,2
2023/2/18 3:10,1,9,0,0,2,2,4
2023/2/18 3:20,1,9,0,0,1,1,2
2023/2/18 3:30,1,9,0,0,2,0,2
2023/2/18 3:40,1,9,0,0,1,1,2
2023/2/18 3:50,1,9,0,0,0,1,1
2023/2/18 4:00,1,9,0,0,2,1,3
2023/2/18 4:10,1,9,0,0,2,0,2
2023/2/18 4:20,1,9,0,0,2,2,4
2023/2/18 4:30,1,9,0,0,1,2,3
2023/2/18 4:40,1,10,0,0,0,2,2
2023/2/18 4:50,1,10,0,0,2,2,4
2023/2/18 5:00,1,10,0,0,1,2,3
2023/2/18 5:10,1,10,0,0,0,0,0
2023/2/18 5:20,1,10,0,0,3,1,4
2023/2/18 5:30,1,10,0,0,0,2,2
2023/2/18 5:40,1,10,0,0,3,0,3
2023/2/18 5:50,1,11,0,0,3,1,4
2023/2/18 6:00,1,11,0,0,5,2,7
2023/2/18 6:10,1,11,0,0,6,0,6
2023/2/18 6:20,1,11,0,0,6,0,6
2023/2/18 6:30,1,11,0,0,9,2,11
2023/2/18 6:40,1,11,0,0,12,2,14
2023/2/18 6:50,1,11,0,0,10,4,14
2023/2/18 7:00,1,11,0,0,14,1,15
2023/2/18 7:10,1,12,0,0,20,2,22
2023/2/18 7:20,1,12,0,0,45,1,46
2023/2/18 7:30,1,12,0,0,56,3,59
2023/2/18 7:40,1,12,0,0,52,4,56
2023/2/18 7:50,1,12,0,0,61,3,64
2023/2/18 8:00,1,13,0,0,39,5,44
2023/2/18 8:10,1,13,0,0,35,3,38
2023/2/18 8:20,1,13,0,0,33,0,33
2023/2/18 8:30,1,13,0,0,32,3,35
2023/2/18 8:40,1,13,0,0,26,3,29
2023/2/18 8:50,1,14,0,0,32,5,37
2023/2/18 9:00,1,14,0,0,27,4,31
2023/2/18 9:10,1,14,0,0,29,4,33
2023/2/18 9:20,1,14,0,0,33,5,38
2023/2/18 9:30,1,14,0,0,38,12,50
2023/2/18 9:40,1,14,0,0,38,18,56
2023/2/18 9:50,1,14,0,0,35,11,46
2023/2/18 10:00,1,14,0,0,36,16,52
2023/2/18 10:10,1,14,0,0,23,9,32
2023/2/18 10:20,1,14,0,0,20,11,31
2023/2/18 10:30,1,14,0,0,21,14,35
2023/2/18 10:40,1,15,0,0,20,14,34
2023/2/18 10:50,1,15,0,0,19,15,34
2023/2/18 11:00,1,15,0,0,17,17,34
2023/2/18 11:10,1,15,0,0,19,16,35
2023/2/18 11:20,1,15,0,0,13,21,34
2023/2/18 11:30,1,15,0,0,13,24,37
2023/2/18 11:40,1,15,0,0,10,25,35
2023/2/18 11:50,1,15,0,0,10,32,42
2023/2/18 12:00,1,15,0,0,9,37,46
2023/2/18 12:10,1,15,0,0,12,26,38
2023/2/18 12:20,1,16,0,0,12,25,37
2023/2/18 12:30,1,16,0,0,13,26,39
2023/2/18 12:40,1,16,0,0,12,36,48
2023/2/18 12:50,1,16,0,0,8,24,32
2023/2/18 13:00,1,16,0,0,11,20,31
2023/2/18 13:10,1,16,0,0,10,19,29
2023/2/18 13:20,1,16,0,0,14,15,29
2023/2/18 13:30,1,16,0,0,17,15,32
2023/2/18 13:40,1,16,0,0,26,16,42
2023/2/18 13:50,1,16,0,0,25,20,45
2023/2/18 14:00,1,16,0,0,20,17,37
2023/2/18 14:10,1,16,0,0,15,20,35
2023/2/18 14:20,1,15,0,0,18,13,31
2023/2/18 14:30,1,15,0,0,13,16,29
2023/2/18 14:40,1,15,0,0,17,15,32
2023/2/18 14:50,1,15,0,0,19,15,34
2023/2/18 15:00,1,15,0,0,23,13,36
2023/2/18 15:10,1,15,0,0,21,13,34
2023/2/18 15:20,1,15,0,0,24,15,39
2023/2/18 15:30,1,15,0,0,26,16,42
2023/2/18 15:40,1,15,0,0,24,21,45
2023/2/18 15:50,1,15,0,0,27,17,44
2023/2/18 16:00,1,15,0,0,22,17,39
2023/2/18 16:10,1,14,0,0,23,17,40
2023/2/18 16:20,1,14,0,0,24,14,38
2023/2/18 16:30,1,14,0,0,29,13,42
2023/2/18 16:40,1,14,0,0,31,10,41
2023/2/18 16:50,1,14,0,0,30,14,44
2023/2/18 17:00,1,13,0,0,34,18,52
2023/2/18 17:10,1,13,0,0,29,18,47
2023/2/18 17:20,1,13,0,0,41,20,61
2023/2/18 17:30,1,13,0,0,31,21,52
2023/2/18 17:40,1,13,0,0,35,28,63
2023/2/18 17:50,1,13,0,0,42,32,74
2023/2/18 18:00,1,13,0,0,46,35,81
2023/2/18 18:10,1,13,0,0,46,28,74
2023/2/18 18:20,1,13,0,0,42,24,66
2023/2/18 18:30,1,12,0,0,44,28,72
2023/2/18 18:40,1,12,0,0,41,24,65
2023/2/18 18:50,1,12,0,0,37,26,63
2023/2/18 19:00,1,12,0,0,29,20,49
2023/2/18 19:10,1,12,0,0,26,18,44
2023/2/18 19:20,1,12,0,0,21,19,40
2023/2/18 19:30,1,12,0,0,20,17,37
2023/2/18 19:40,1,12,0,0,23,17,40
2023/2/18 19:50,1,11,0,0,22,19,41
2023/2/18 20:00,1,11,0,0,20,23,43
2023/2/18 20:10,1,11,0,0,15,23,38
2023/2/18 20:20,1,11,0,0,17,23,40
2023/2/18 20:30,1,11,0,0,14,27,41
2023/2/18 20:40,1,11,0,0,18,31,49
2023/2/18 20:50,1,11,0,0,14,34,48
2023/2/18 21:00,1,10,0,0,13,39,52
2023/2/18 21:10,1,10,0,0,13,28,41
2023/2/18 21:20,1,10,0,0,11,27,38
2023/2/18 21:30,1,10,0,0,8,26,34
2023/2/18 21:40,1,9,0,0,9,43,52
2023/2/18 21:50,1,9,0,0,7,40,47
2023/2/18 22:00,1,9,0,0,7,39,46
2023/2/18 22:10,1,9,0,0,3,28,31
2023/2/18 22:20,1,8,0,0,4,30,34
2023/2/18 22:30,1,8,0,0,3,17,20
2023/2/18 22:40,1,8,0,0,3,12,15
2023/2/18 22:50,1,8,0,0,4,8,12
2023/2/18 23:00,1,8,0,0,2,7,9
2023/2/18 23:10,1,8,0,0,3,6,9
2023/2/18 23:20,1,8,0,0,0,3,3
2023/2/18 23:30,1,8,0,0,2,0,2
2023/2/18 23:40,1,8,0,0,2,2,4
2023/2/18 23:50,1,7,0,0,2,1,3
2023/2/19 0:00,1,7,0,0,2,2,4
2023/2/19 0:10,1,7,0,0,2,1,3
2023/2/19 0:20,1,7,0,0,2,2,4
2023/2/19 0:30,1,6,0,0,0,2,2
2023/2/19 0:40,1,6,0,0,1,1,2
2023/2/19 0:50,1,6,0,0,1,0,1
2023/2/19 1:00,1,6,0,0,1,0,1
2023/2/19 1:10,1,6,0,0,1,0,1
2023/2/19 1:20,1,6,0,0,1,1,2
2023/2/19 1:30,1,6,0,0,2,2,4
2023/2/19 1:40,1,6,0,0,1,0,1
2023/2/19 1:50,1,6,0,0,0,1,1
2023/2/19 2:00,1,6,0,0,2,2,4
2023/2/19 2:10,1,6,0,0,0,2,2
2023/2/19 2:20,1,6,0,0,2,2,4
2023/2/19 2:30,1,6,0,0,0,1,1
2023/2/19 2:40,1,6,0,0,2,0,2
2023/2/19 2:50,1,5,0,0,2,0,2
2023/2/19 3:00,1,5,0,0,1,2,3
2023/2/19 3:10,1,5,0,0,1,2,3
2023/2/19 3:20,1,5,0,0,0,1,1
2023/2/19 3:30,1,5,0,0,1,1,2
2023/2/19 3:40,1,5,0,0,2,1,3
2023/2/19 3:50,1,5,0,0,2,2,4
2023/2/19 4:00,1,5,0,0,1,1,2
2023/2/19 4:10,1,5,0,0,2,2,4
2023/2/19 4:20,1,5,0,0,2,0,2
2023/2/19 4:30,1,5,0,0,0,0,0
2023/2/19 4:40,1,6,0,0,0,1,1
2023/2/19 4:50,1,6,0,0,1,0,1
2023/2/19 5:00,1,6,0,0,1,1,2
2023/2/19 5:10,1,6,0,0,0,0,0
2023/2/19 5:20,1,6,0,0,2,0,2
2023/2/19 5:30,1,6,0,0,0,1,1
2023/2/19 5:40,1,7,0,0,1,0,1
2023/2/19 5:50,1,7,0,0,4,2,6
2023/2/19 6:00,1,7,0,0,4,2,6
2023/2/19 6:10,1,7,0,0,9,2,11
2023/2/19 6:20,1,7,0,0,5,0,5
2023/2/19 6:30,1,7,0,0,10,2,12
2023/2/19 6:40,1,7,0,0,13,1,14
2023/2/19 6:50,1,8,0,0,10,3,13
2023/2/19 7:00,1,8,0,0,15,1,16
2023/2/19 7:10,1,8,0,0,18,2,20
2023/2/19 7:20,1,8,0,0,43,2,45
2023/2/19 7:30,1,9,0,0,53,5,58
2023/2/19 7:40,1,9,0,0,60,3,63
2023/2/19 7:50,1,9,0,0,59,3,62
2023/2/19 8:00,1,9,0,0,40,4,44
2023/2/19 8:10,1,9,0,0,44,4,48
2023/2/19 8:20,1,10,0,0,35,2,37
2023/2/19 8:30,1,10,0,0,34,1,35
2023/2/19 8:40,1,10,0,0,27,5,32
2023/2/19 8:50,1,11,0,0,29,4,33
2023/2/19 9:00,1,11,0,0,32,2,34
2023/2/19 9:10,1,11,0,0,29,4,33
2023/2/19 9:20,1,11,0,0,35,8,43
2023/2/19 9:30,1,11,0,0,36,12,48
2023/2/19 9:40,1,11,0,0,36,17,53
2023/2/19 9:50,1,11,0,0,43,11,54
2023/2/19 10:00,1,11,0,0,30,15,45
2023/2/19 10:10,1,11,0,0,26,9,35
2023/2/19 10:20,1,11,0,0,19,11,30
2023/2/19 10:30,1,11,0,0,23,14,37
2023/2/19 10:40,1,11,0,0,23,14,37
2023/2/19 10:50,1,12,0,0,19,16,35
2023/2/19 11:00,1,12,0,0,14,19,33
2023/2/19 11:10,1,12,0,0,18,15,33
2023/2/19 11:20,1,12,0,0,12,21,33
2023/2/19 11:30,1,12,0,0,17,24,41
2023/2/19 11:40,1,12,0,0,13,24,37
2023/2/19 11:50,1,13,0,0,14,34,48
2023/2/19 12:00,1,13,0,0,10,29,39
2023/2/19 12:10,1,13,0,0,16,28,44
2023/2/19 12:20,1,13,0,0,14,28,42
2023/2/19 12:30,1,13,0,0,14,32,46
2023/2/19 12:40,1,13,0,0,14,32,46
2023/2/19 12:50,1,13,0,0,8,25,33
2023/2/19 13:00,1,14,0,0,9,20,29
2023/2/19 13:10,1,14,0,0,10,17,27
2023/2/19 13:20,1,14,0,0,15,17,32
2023/2/19 13:30,1,14,0,0,17,15,32
2023/2/19 13:40,1,14,0,0,27,20,47
2023/2/19 13:50,1,14,0,0,26,22,48
2023/2/19 14:00,1,14,0,0,21,21,42
2023/2/19 14:10,1,14,0,0,20,23,43
2023/2/19 14:20,1,14,0,0,16,13,29
2023/2/19 14:30,1,15,0,0,17,19,36
2023/2/19 14:40,1,15,0,0,18,12,30
2023/2/19 14:50,1,15,0,0,15,13,28
2023/2/19 15:00,1,15,0,0,21,9,30
2023/2/19 15:10,1,15,0,0,25,13,38
2023/2/19 15:20,1,15,0,0,21,15,36
2023/2/19 15:30,1,16,0,0,26,17,43
2023/2/19 15:40,1,16,0,0,22,16,38
2023/2/19 15:50,1,16,0,0,26,17,43
2023/2/19 16:00,1,16,0,0,25,13,38
2023/2/19 16:10,1,16,0,0,21,14,35
2023/2/19 16:20,1,17,0,0,23,13,36
2023/2/19 16:30,1,17,0,0,30,13,43
2023/2/19 16:40,1,17,0,0,27,11,38
2023/2/19 16:50,1,17,0,0,30,15,45
2023/2/19 17:00,1,17,0,0,39,16,55
2023/2/19 17:10,1,17,0,0,29,22,51
2023/2/19 17:20,1,17,0,0,35,23,58
2023/2/19 17:30,1,18,0,0,32,23,55
2023/2/19 17:40,1,18,0,0,31,34,65
2023/2/19 17:50,1,18,0,0,32,34,66
2023/2/19 18:00,1,18,0,0,53,35,88
2023/2/19 18:10,1,18,0,0,46,33,79
2023/2/19 18:20,1,18,0,0,46,30,76
2023/2/19 18:30,1,18,0,0,40,31,71
2023/2/19 18:40,1,18,0,0,42,22,64
2023/2/19 18:50,1,18,0,0,40,29,69
2023/2/19 19:00,1,18,0,0,32,22,54
2023/2/19 19:10,1,18,0,0,28,21,49
2023/2/19 19:20,1,17,0,0,25,19,44
2023/2/19 19:30,1,17,0,0,22,17,39
2023/2/19 19:40,1,17,0,0,27,19,46
2023/2/19 19:50,1,17,0,0,22,15,37
2023/2/19 20:00,1,17,0,0,25,20,45
2023/2/19 20:10,1,17,0,0,17,22,39
2023/2/19 20:20,1,16,0,0,14,22,36
2023/2/19 20:30,1,16,0,0,15,32,47
2023/2/19 20:40,1,16,0,0,15,27,42
2023/2/19 20:50,1,16,0,0,13,30,43
2023/2/19 21:00,1,16,0,0,11,34,45
2023/2/19 21:10,1,15,0,0,13,26,39
2023/2/19 21:20,1,15,0,0,13,24,37
2023/2/19 21:30,1,15,0,0,9,20,29
2023/2/19 21:40,1,15,0,0,7,35,42
2023/2/19 21:50,1,15,0,0,7,38,45
2023/2/19 22:00,1,14,0,0,4,32,36
2023/2/19 22:10,1,14,0,0,3,31,34
2023/2/19 22:20,1,14,0,0,3,27,30
2023/2/19 22:30,1,14,0,0,3,20,23
2023/2/19 22:40,1,13,0,0,3,10,13
2023/2/19 22:50,1,13,0,0,4,11,15
2023/2/19 23:00,1,13,0,0,3,6,9
2023/2/19 23:10,1,13,0,0,2,6,8
2023/2/19 23:20,1,13,0,0,2,2,4
2023/2/19 23:30,1,12,0,0,2,2,4
2023/2/19 23:40,1,12,0,0,2,2,4
2023/2/19 23:50,1,12,0,0,1,2,3
2023/2/20 0:00,1,12,1,0,5,1,6
2023/2/20 0:10,1,11,1,0,2,0,2
2023/2/20 0:20,1,11,1,0,2,1,3
2023/2/20 0:30,1,11,1,0,2,1,3
2023/2/20 0:40,1,11,1,0,2,2,4
2023/2/20 0:50,1,10,1,0,2,2,4
2023/2/20 1:00,1,10,1,0,0,2,2
2023/2/20 1:10,1,10,1,0,2,0,2
2023/2/20 1:20,1,10,1,0,2,1,3
2023/2/20 1:30,1,10,1,0,0,0,0
2023/2/20 1:40,1,10,1,0,2,1,3
2023/2/20 1:50,1,9,1,0,0,0,0
2023/2/20 2:00,1,9,1,0,0,0,0
2023/2/20 2:10,1,9,1,0,1,0,1
2023/2/20 2:20,1,8,1,0,2,0,2
2023/2/20 2:30,1,8,1,0,0,0,0
2023/2/20 2:40,1,8,1,0,2,2,4
2023/2/20 2:50,1,8,1,0,2,0,2
2023/2/20 3:00,1,8,1,0,2,1,3
2023/2/20 3:10,1,8,1,0,1,1,2
2023/2/20 3:20,1,8,1,0,0,1,1
2023/2/20 3:30,1,7,1,0,0,0,0
2023/2/20 3:40,1,7,1,0,2,2,4
2023/2/20 3:50,1,7,1,0,2,0,2
2023/2/20 4:00,1,7,1,0,0,2,2
2023/2/20 4:10,1,7,1,0,1,2,3
2023/2/20 4:20,1,7,1,0,0,2,2
2023/2/20 4:30,1,7,1,0,2,1,3
2023/2/20 4:40,1,7,1,0,0,1,1
2023/2/20 4:50,1,7,1,0,1,2,3
2023/2/20 5:00,1,7,1,0,2,1,3
2023/2/20 5:10,1,8,1,0,1,2,3
2023/2/20 5:20,1,8,1,0,2,1,3
2023/2/20 5:30,1,8,1,0,1,2,3
2023/2/20 5:40,1,8,1,0,0,1,1
2023/2/20 5:50,1,9,1,0,5,2,7
2023/2/20 6:00,1,9,1,0,4,4,8
2023/2/20 6:10,1,9,1,0,4,3,7
2023/2/20 6:20,1,9,1,0,7,1,8
2023/2/20 6:30,1,9,1,0,7,4,11
2023/2/20 6:40,1,9,1,0,12,2,14
2023/2/20 6:50,1,9,1,0,33,1,34
2023/2/20 7:00,1,10,1,0,54,3,57
2023/2/20 7:10,1,10,1,0,89,1,90
2023/2/20 7:20,1,11,1,0,117,1,118
2023/2/20 7:30,1,11,1,0,280,1,281
2023/2/20 7:40,1,11,1,0,557,5,562
2023/2/20 7:50,1,11,1,0,552,3,555
2023/2/20 8:00,1,11,1,0,259,7,266
2023/2/20 8:10,1,11,1,0,136,8,144
2023/2/20 8:20,1,11,1,0,85,8,93
2023/2/20 8:30,1,11,1,0,79,15,94
2023/2/20 8:40,1,12,1,0,73,16,89
2023/2/20 8:50,1,12,1,0,82,14,96
2023/2/20 9:00,1,12,1,0,91,17,108
2023/2/20 9:10,1,12,1,0,92,20,112
2023/2/20 9:20,1,12,1,0,142,28,170
2023/2/20 9:30,1,12,1,0,233,39,272
2023/2/20 9:40,1,12,1,0,247,114,361
2023/2/20 9:50,1,12,1,0,182,174,356
2023/2/20 10:00,1,12,1,0,132,150,282
2023/2/20 10:10,1,13,1,0,79,108,187
2023/2/20 10:20,1,13,1,0,80,80,160
2023/2/20 10:30,1,13,1,0,60,53,113
2023/2/20 10:40,1,13,1,0,67,44,111
2023/2/20 10:50,1,13,1,0,71,41,112
2023/2/20 11:00,1,13,1,0,58,37,95
2023/2/20 11:10,1,13,1,0,59,41,100
2023/2/20 11:20,1,13,1,0,55,50,105
2023/2/20 11:30,1,14,1,0,64,78,142
2023/2/20 11:40,1,14,1,0,82,236,318
2023/2/20 11:50,1,14,1,0,76,277,353
2023/2/20 12:00,1,14,1,0,55,271,326
2023/2/20 12:10,1,14,1,0,55,158,213
2023/2/20 12:20,1,15,1,0,54,131,185
2023/2/20 12:30,1,15,1,0,67,81,148
2023/2/20 12:40,1,15,1,0,57,64,121
2023/2/20 12:50,1,15,1,0,65,51,116
2023/2/20 13:00,1,16,1,0,68,27,95
2023/2/20 13:10,1,16,1,0,68,30,98
2023/2/20 13:20,1,16,1,0,95,32,127
2023/2/20 13:30,1,16,1,0,143,39,182
2023/2/20 13:40,1,17,1,0,229,31,260
2023/2/20 13:50,1,17,1,0,269,39,308
2023/2/20 14:00,1,17,1,0,121,27,148
2023/2/20 14:10,1,17,1,0,94,35,129
2023/2/20 14:20,1,17,1,0,104,44,148
2023/2/20 14:30,1,17,1,0,91,39,130
2023/2/20 14:40,1,17,1,0,87,48,135
2023/2/20 14:50,1,17,1,0,77,44,121
2023/2/20 15:00,1,18,1,0,65,39,104
2023/2/20 15:10,1,18,1,0,84,46,130
2023/2/20 15:20,1,18,1,0,82,39,121
2023/2/20 15:30,1,18,1,0,89,65,154
2023/2/20 15:40,1,18,1,0,147,173,320
2023/2/20 15:50,1,19,1,0,141,195,336
2023/2/20 16:00,1,19,1,0,96,155,251
2023/2/20 16:10,1,19,1,0,98,121,219
2023/2/20 16:20,1,19,1,0,71,74,145
2023/2/20 16:30,1,19,1,0,83,78,161
2023/2/20 16:40,1,19,1,0,76,60,136
2023/2/20 16:50,1,19,1,0,78,64,142
2023/2/20 17:00,1,19,1,0,76,61,137
2023/2/20 17:10,1,19,1,0,61,57,118
2023/2/20 17:20,1,19,1,0,82,59,141
2023/2/20 17:30,1,19,1,0,81,74,155
2023/2/20 17:40,1,19,1,0,77,252,329
2023/2/20 17:50,1,19,1,0,108,255,363
2023/2/20 18:00,1,19,1,0,89,190,279
2023/2/20 18:10,1,18,1,0,94,143,237
2023/2/20 18:20,1,18,1,0,92,91,183
2023/2/20 18:30,1,18,1,0,124,77,201
2023/2/20 18:40,1,18,1,0,201,71,272
2023/2/20 18:50,1,17,1,0,181,60,241
2023/2/20 19:00,1,17,1,0,130,62,192
2023/2/20 19:10,1,17,1,0,135,64,199
2023/2/20 19:20,1,16,1,0,86,63,149
2023/2/20 19:30,1,16,1,0,94,57,151
2023/2/20 19:40,1,15,1,0,87,52,139
2023/2/20 19:50,1,15,1,0,94,56,150
2023/2/20 20:00,1,15,1,0,76,73,149
2023/2/20 20:10,1,15,1,0,83,58,141
2023/2/20 20:20,1,15,1,0,73,60,133
2023/2/20 20:30,1,15,1,0,73,105,178
2023/2/20 20:40,1,15,1,0,64,191,255
2023/2/20 20:50,1,15,1,0,52,247,299
2023/2/20 21:00,1,14,1,0,49,169,218
2023/2/20 21:10,1,14,1,0,57,146,203
2023/2/20 21:20,1,14,1,0,27,122,149
2023/2/20 21:30,1,14,1,0,25,69,94
2023/2/20 21:40,1,14,1,0,17,79,96
2023/2/20 21:50,1,14,1,0,19,72,91
2023/2/20 22:00,1,13,1,0,17,82,99
2023/2/20 22:10,1,13,1,0,13,79,92
2023/2/20 22:20,1,13,1,0,15,51,66
2023/2/20 22:30,1,13,1,0,16,36,52
2023/2/20 22:40,1,12,1,0,12,19,31
2023/2/20 22:50,1,12,1,0,10,15,25
2023/2/20 23:00,1,12,1,0,9,11,20
2023/2/20 23:10,1,12,1,0,7,12,19
2023/2/20 23:20,1,12,1,0,6,8,14
2023/2/20 23:30,1,11,1,0,3,10,13
2023/2/20 23:40,1,11,1,0,1,10,11
2023/2/20 23:50,1,11,1,0,2,5,7
2023/2/21 0:00,1,11,1,0,4,2,6
2023/2/21 0:10,1,11,1,0,3,2,5
2023/2/21 0:20,1,11,1,0,4,1,5
2023/2/21 0:30,1,11,1,0,0,2,2
2023/2/21 0:40,1,10,1,0,2,2,4
2023/2/21 0:50,1,10,1,0,1,2,3
2023/2/21 1:00,1,10,1,0,0,0,0
2023/2/21 1:10,1,10,1,0,1,2,3
2023/2/21 1:20,1,9,1,0,0,0,0
2023/2/21 1:30,1,9,1,0,0,1,1
2023/2/21 1:40,1,9,1,0,0,1,1
2023/2/21 1:50,1,8,1,0,1,2,3
2023/2/21 2:00,1,8,1,0,1,1,2
2023/2/21 2:10,1,8,1,0,0,2,2
2023/2/21 2:20,1,8,1,0,0,0,0
2023/2/21 2:30,1,8,1,0,1,0,1
2023/2/21 2:40,1,8,1,0,0,0,0
2023/2/21 2:50,1,8,1,0,1,0,1
2023/2/21 3:00,1,7,1,0,1,0,1
2023/2/21 3:10,1,7,1,0,0,0,0
2023/2/21 3:20,1,7,1,0,1,2,3
2023/2/21 3:30,1,6,1,0,0,0,0
2023/2/21 3:40,1,6,1,0,0,0,0
2023/2/21 3:50,1,6,1,0,0,1,1
2023/2/21 4:00,1,6,1,0,2,2,4
2023/2/21 4:10,1,6,1,0,1,0,1
2023/2/21 4:20,1,6,1,0,0,1,1
2023/2/21 4:30,1,6,1,0,0,1,1
2023/2/21 4:40,1,6,1,0,0,1,1
2023/2/21 4:50,1,6,1,0,2,2,4
2023/2/21 5:00,1,6,1,0,1,0,1
2023/2/21 5:10,1,6,1,0,2,1,3
2023/2/21 5:20,1,6,1,0,0,1,1
2023/2/21 5:30,1,7,1,0,2,2,4
2023/2/21 5:40,1,7,1,0,1,0,1
2023/2/21 5:50,1,7,1,0,4,2,6
2023/2/21 6:00,1,7,1,0,2,3,5
2023/2/21 6:10,1,7,1,0,4,1,5
2023/2/21 6:20,1,7,1,0,5,2,7
2023/2/21 6:30,1,8,1,0,6,3,9
2023/2/21 6:40,1,8,1,0,13,2,15
2023/2/21 6:50,1,8,1,0,35,1,36
2023/2/21 7:00,1,8,1,0,59,4,63
2023/2/21 7:10,1,8,1,0,82,1,83
2023/2/21 7:20,1,8,1,0,96,1,97
2023/2/21 7:30,1,8,1,0,281,1,282
2023/2/21 7:40,1,9,1,0,583,5,588
2023/2/21 7:50,1,9,1,0,579,4,583
2023/2/21 8:00,1,9,1,0,256,8,264
2023/2/21 8:10,1,9,1,0,137,11,148
2023/2/21 8:20,1,9,1,0,91,10,101
2023/2/21 8:30,1,9,1,0,76,12,88
2023/2/21 8:40,1,10,1,0,88,15,103
2023/2/21 8:50,1,10,1,0,75,12,87
2023/2/21 9:00,1,10,1,0,79,16,95
2023/2/21 9:10,1,10,1,0,81,17,98
2023/2/21 9:20,1,10,1,0,161,25,186
2023/2/21 9:30,1,10,1,0,200,38,238
2023/2/21 9:40,1,10,1,0,259,122,381
2023/2/21 9:50,1,11,1,0,184,165,349
2023/2/21 10:00,1,12,1,0,123,149,272
2023/2/21 10:10,1,12,1,0,83,105,188
2023/2/21 10:20,1,12,1,0,78,72,150
2023/2/21 10:30,1,12,1,0,64,44,108
2023/2/21 10:40,1,12,1,0,61,46,107
2023/2/21 10:50,1,12,1,0,61,37,98
2023/2/21 11:00,1,12,1,0,66,41,107
2023/2/21 11:10,1,12,1,0,58,38,96
2023/2/21 11:20,1,13,1,0,60,40,100
2023/2/21 11:30,1,13,1,0,66,63,129
2023/2/21 11:40,1,13,1,0,69,204,273
2023/2/21 11:50,1,13,1,0,63,302,365
2023/2/21 12:00,1,13,1,0,53,270,323
2023/2/21 12:10,1,13,1,0,50,187,237
2023/2/21 12:20,1,14,1,0,57,123,180
2023/2/21 12:30,1,14,1,0,60,82,142
2023/2/21 12:40,1,14,1,0,65,60,125
2023/2/21 12:50,1,14,1,0,53,49,102
2023/2/21 13:00,1,14,1,0,57,27,84
2023/2/21 13:10,1,14,1,0,70,37,107
2023/2/21 13:20,1,15,1,0,83,36,119
2023/2/21 13:30,1,15,1,0,184,31,215
2023/2/21 13:40,1,15,1,0,225,37,262
2023/2/21 13:50,1,15,1,0,224,37,261
2023/2/21 14:00,1,16,1,0,117,29,146
2023/2/21 14:10,1,16,1,0,107,40,147
2023/2/21 14:20,1,16,1,0,102,35,137
2023/2/21 14:30,1,16,1,0,96,47,143
2023/2/21 14:40,1,16,1,0,85,38,123
2023/2/21 14:50,1,16,1,0,72,40,112
2023/2/21 15:00,1,16,1,0,68,45,113
2023/2/21 15:10,1,16,1,0,79,43,122
2023/2/21 15:20,1,16,1,0,83,38,121
2023/2/21 15:30,1,17,1,0,96,59,155
2023/2/21 15:40,1,17,1,0,130,167,297
2023/2/21 15:50,1,17,1,0,162,241,403
2023/2/21 16:00,1,17,1,0,113,163,276
2023/2/21 16:10,1,17,1,0,83,131,214
2023/2/21 16:20,1,17,1,0,69,77,146
2023/2/21 16:30,1,16,1,0,75,71,146
2023/2/21 16:40,1,16,1,0,71,51,122
2023/2/21 16:50,1,16,1,0,74,59,133
2023/2/21 17:00,1,16,1,0,74,59,133
2023/2/21 17:10,1,16,1,0,67,62,129
2023/2/21 17:20,1,16,1,0,82,61,143
2023/2/21 17:30,1,15,1,0,87,82,169
2023/2/21 17:40,1,15,1,0,88,254,342
2023/2/21 17:50,1,15,1,0,103,238,341
2023/2/21 18:00,1,15,1,0,93,208,301
2023/2/21 18:10,1,15,1,0,78,122,200
2023/2/21 18:20,1,15,1,0,95,105,200
2023/2/21 18:30,1,14,1,0,117,84,201
2023/2/21 18:40,1,14,1,0,195,68,263
2023/2/21 18:50,1,14,1,0,186,67,253
2023/2/21 19:00,1,14,1,0,127,68,195
2023/2/21 19:10,1,14,1,0,121,56,177
2023/2/21 19:20,1,14,1,0,102,60,162
2023/2/21 19:30,1,14,1,0,86,64,150
2023/2/21 19:40,1,14,1,0,91,64,155
2023/2/21 19:50,1,14,1,0,86,68,154
2023/2/21 20:00,1,14,1,0,89,74,163
2023/2/21 20:10,1,13,1,0,74,66,140
2023/2/21 20:20,1,13,1,0,85,57,142
2023/2/21 20:30,1,13,1,0,60,96,156
2023/2/21 20:40,1,13,1,0,60,206,266
2023/2/21 20:50,1,13,1,0,48,250,298
2023/2/21 21:00,1,13,1,0,45,151,196
2023/2/21 21:10,1,13,1,0,57,136,193
2023/2/21 21:20,1,12,1,0,28,113,141
2023/2/21 21:30,1,12,1,0,20,72,92
2023/2/21 21:40,1,12,1,0,20,71,91
2023/2/21 21:50,1,12,1,0,16,80,96
2023/2/21 22:00,1,12,1,0,18,91,109
2023/2/21 22:10,1,12,1,0,15,75,90
2023/2/21 22:20,1,12,1,0,17,49,66
2023/2/21 22:30,1,11,1,0,15,34,49
2023/2/21 22:40,1,11,1,0,11,23,34
2023/2/21 22:50,1,11,1,0,11,13,24
2023/2/21 23:00,1,11,1,0,10,13,23
2023/2/21 23:10,1,11,1,0,8,12,20
2023/2/21 23:20,1,11,1,0,5,11,16
2023/2/21 23:30,1,10,1,0,1,9,10
2023/2/21 23:40,1,10,1,0,2,11,13
2023/2/21 23:50,1,10,1,0,0,3,3
2023/2/22 0:00,1,10,1,0,4,2,6
2023/2/22 0:10,1,10,1,0,4,2,6
2023/2/22 0:20,1,10,1,0,3,2,5
2023/2/22 0:30,1,9,1,0,1,0,1
2023/2/22 0:40,1,9,1,0,3,0,3
2023/2/22 0:50,1,9,1,0,0,2,2
2023/2/22 1:00,1,9,1,0,0,0,0
2023/2/22 1:10,1,9,1,0,1,0,1
2023/2/22 1:20,1,9,1,0,2,1,3
2023/2/22 1:30,1,9,1,0,0,1,1
2023/2/22 1:40,1,9,1,0,2,0,2
2023/2/22 1:50,1,9,1,0,1,0,1
2023/2/22 2:00,1,8,1,0,0,1,1
2023/2/22 2:10,1,8,1,0,0,1,1
2023/2/22 2:20,1,8,1,0,1,2,3
2023/2/22 2:30,1,8,1,0,2,0,2
2023/2/22 2:40,1,7,1,0,2,1,3
2023/2/22 2:50,1,7,1,0,2,2,4
2023/2/22 3:00,1,7,1,0,0,2,2
2023/2/22 3:10,1,7,1,0,1,1,2
2023/2/22 3:20,1,7,1,0,1,1,2
2023/2/22 3:30,1,7,1,0,0,2,2
2023/2/22 3:40,1,7,1,0,0,2,2
2023/2/22 3:50,1,7,1,0,1,2,3
2023/2/22 4:00,1,7,1,0,1,2,3
2023/2/22 4:10,1,7,1,0,0,2,2
2023/2/22 4:20,1,7,1,0,2,1,3
2023/2/22 4:30,1,7,1,0,1,1,2
2023/2/22 4:40,1,7,1,0,2,2,4
2023/2/22 4:50,1,7,1,0,0,2,2
2023/2/22 5:00,1,7,1,0,0,2,2
2023/2/22 5:10,1,7,1,0,1,0,1
2023/2/22 5:20,1,7,1,0,1,1,2
2023/2/22 5:30,1,7,1,0,2,1,3
2023/2/22 5:40,1,7,1,0,0,2,2
2023/2/22 5:50,1,7,1,0,3,1,4
2023/2/22 6:00,1,7,1,0,4,3,7
2023/2/22 6:10,1,7,1,0,4,2,6
2023/2/22 6:20,1,7,1,0,5,1,6
2023/2/22 6:30,1,7,1,0,4,2,6
2023/2/22 6:40,1,7,1,0,10,1,11
2023/2/22 6:50,1,7,1,0,40,2,42
2023/2/22 7:00,1,7,1,0,66,2,68
2023/2/22 7:10,1,7,1,0,89,2,91
2023/2/22 7:20,1,7,1,0,100,2,102
2023/2/22 7:30,1,7,1,0,299,2,301
2023/2/22 7:40,1,7,1,0,556,3,559
2023/2/22 7:50,1,7,1,0,568,3,571
2023/2/22 8:00,1,7,1,0,331,6,337
2023/2/22 8:10,1,7,1,0,137,10,147
2023/2/22 8:20,1,7,1,0,91,11,102
2023/2/22 8:30,1,8,1,0,81,13,94
2023/2/22 8:40,1,8,1,0,83,15,98
2023/2/22 8:50,1,8,1,0,78,13,91
2023/2/22 9:00,1,8,1,0,77,16,93
2023/2/22 9:10,1,8,1,0,95,17,112
2023/2/22 9:20,1,8,1,0,171,27,198
2023/2/22 9:30,1,8,1,0,242,47,289
2023/2/22 9:40,1,8,1,0,262,143,405
2023/2/22 9:50,1,8,1,0,175,180,355
2023/2/22 10:00,1,8,1,0,141,153,294
2023/2/22 10:10,1,8,1,0,81,111,192
2023/2/22 10:20,1,8,1,0,72,64,136
2023/2/22 10:30,1,8,1,0,57,49,106
2023/2/22 10:40,1,8,1,0,69,41,110
2023/2/22 10:50,1,8,1,0,66,44,110
2023/2/22 11:00,1,8,1,0,60,34,94
2023/2/22 11:10,1,8,1,0,59,37,96
2023/2/22 11:20,1,8,1,0,64,51,115
2023/2/22 11:30,1,8,1,0,71,75,146
2023/2/22 11:40,1,8,1,0,64,247,311
2023/2/22 11:50,1,8,1,0,62,306,368
2023/2/22 12:00,1,8,1,0,59,236,295
2023/2/22 12:10,1,8,1,0,60,168,228
2023/2/22 12:20,1,8,1,0,58,107,165
2023/2/22 12:30,1,8,1,0,38,96,134
2023/2/22 12:40,1,8,1,0,27,62,89
2023/2/22 12:50,1,8,1,0,20,54,74
2023/2/22 13:00,1,8,1,0,19,33,52
2023/2/22 13:10,1,8,1,0,11,21,32
2023/2/22 13:20,1,8,1,0,17,16,33
2023/2/22 13:30,1,8,1,0,16,15,31
2023/2/22 13:40,1,8,1,0,34,24,58
2023/2/22 13:50,1,8,1,0,33,20,53
2023/2/22 14:00,1,8,1,0,27,20,47
2023/2/22 14:10,1,8,1,0,23,24,47
2023/2/22 14:20,1,8,1,0,18,19,37
2023/2/22 14:30,1,8,1,0,18,19,37
2023/2/22 14:40,1,8,1,0,19,19,38
2023/2/22 14:50,1,8,1,0,19,14,33
2023/2/22 15:00,1,8,1,0,26,13,39
2023/2/22 15:10,1,8,1,0,26,16,42
2023/2/22 15:20,1,8,1,0,24,18,42
2023/2/22 15:30,1,8,1,0,29,16,45
2023/2/22 15:40,1,8,1,0,32,21,53
2023/2/22 15:50,1,8,1,0,35,19,54
2023/2/22 16:00,1,7,1,0,30,18,48
2023/2/22 16:10,1,7,1,0,26,21,47
2023/2/22 16:20,1,7,1,0,28,14,42
2023/2/22 16:30,1,7,1,0,37,13,50
2023/2/22 16:40,1,7,1,0,39,12,51
2023/2/22 16:50,1,7,1,0,35,17,52
2023/2/22 17:00,1,7,1,0,43,20,63
2023/2/22 17:10,1,7,1,0,42,22,64
2023/2/22 17:20,1,7,1,0,47,23,70
2023/2/22 17:30,1,7,1,0,43,31,74
2023/2/22 17:40,1,7,1,0,38,35,73
2023/2/22 17:50,1,7,1,0,49,46,95
2023/2/22 18:00,1,7,1,0,51,35,86
2023/2/22 18:10,1,7,1,0,52,37,89
2023/2/22 18:20,1,7,1,0,56,30,86
2023/2/22 18:30,1,7,1,0,44,31,75
2023/2/22 18:40,1,7,1,0,46,27,73
2023/2/22 18:50,1,7,1,0,42,34,76
2023/2/22 19:00,1,7,1,0,41,22,63
2023/2/22 19:10,1,7,1,0,38,24,62
2023/2/22 19:20,1,7,1,0,32,24,56
2023/2/22 19:30,1,7,1,0,32,23,55
2023/2/22 19:40,1,7,1,0,26,24,50
2023/2/22 19:50,1,7,1,0,22,20,42
2023/2/22 20:00,1,7,1,0,26,27,53
2023/2/22 20:10,1,7,1,0,19,25,44
2023/2/22 20:20,1,7,1,0,18,30,48
2023/2/22 20:30,1,7,1,0,17,37,54
2023/2/22 20:40,1,7,1,0,21,41,62
2023/2/22 20:50,1,6,1,0,19,37,56
2023/2/22 21:00,1,6,1,0,14,42,56
2023/2/22 21:10,1,6,1,0,15,34,49
2023/2/22 21:20,1,6,1,0,11,32,43
2023/2/22 21:30,1,6,1,0,14,25,39
2023/2/22 21:40,1,6,1,0,10,51,61
2023/2/22 21:50,1,6,1,0,9,52,61
2023/2/22 22:00,1,6,1,0,8,38,46
2023/2/22 22:10,1,6,1,0,6,36,42
2023/2/22 22:20,1,6,1,0,3,34,37
2023/2/22 22:30,1,6,1,0,1,23,24
2023/2/22 22:40,1,6,1,0,1,16,17
2023/2/22 22:50,1,6,1,0,3,13,16
2023/2/22 23:00,1,6,1,0,3,7,10
2023/2/22 23:10,1,6,1,0,2,6,8
2023/2/22 23:20,1,6,1,0,2,3,5
2023/2/22 23:30,1,6,1,0,2,1,3
2023/2/22 23:40,1,5,1,0,0,2,2
2023/2/22 23:50,1,5,1,0,2,1,3
2023/2/23 0:00,1,5,1,0,5,1,6
2023/2/23 0:10,1,5,1,0,2,2,4
2023/2/23 0:20,1,5,1,0,4,2,6
2023/2/23 0:30,1,5,1,0,2,2,4
2023/2/23 0:40,1,5,1,0,1,0,1
2023/2/23 0:50,1,5,1,0,0,1,1
2023/2/23 1:00,1,5,1,0,1,2,3
2023/2/23 1:10,1,5,1,0,1,2,3
2023/2/23 1:20,1,5,1,0,1,1,2
2023/2/23 1:30,1,5,1,0,0,0,0
2023/2/23 1:40,1,5,1,0,0,0,0
2023/2/23 1:50,1,5,1,0,2,0,2
2023/2/23 2:00,1,5,1,0,0,1,1
2023/2/23 2:10,1,5,1,0,2,1,3
2023/2/23 2:20,1,5,1,0,2,2,4
2023/2/23 2:30,1,5,1,0,1,0,1
2023/2/23 2:40,1,5,1,0,2,1,3
2023/2/23 2:50,1,5,1,0,1,0,1
2023/2/23 3:00,1,5,1,0,0,1,1
2023/2/23 3:10,1,5,1,0,0,2,2
2023/2/23 3:20,1,5,1,0,0,2,2
2023/2/23 3:30,1,5,1,0,0,1,1
2023/2/23 3:40,1,5,1,0,2,2,4
2023/2/23 3:50,1,5,1,0,2,1,3
2023/2/23 4:00,1,5,1,0,2,1,3
2023/2/23 4:10,1,5,1,0,2,0,2
2023/2/23 4:20,1,5,1,0,2,1,3
2023/2/23 4:30,1,5,1,0,2,0,2
2023/2/23 4:40,1,5,1,0,2,0,2
2023/2/23 4:50,1,5,1,0,2,2,4
2023/2/23 5:00,1,5,1,0,2,0,2
2023/2/23 5:10,1,5,1,0,1,1,2
2023/2/23 5:20,1,5,1,0,0,2,2
2023/2/23 5:30,1,5,1,0,3,0,3
2023/2/23 5:40,1,5,1,0,0,2,2
2023/2/23 5:50,1,5,1,0,4,0,4
2023/2/23 6:00,1,5,1,0,3,2,5
2023/2/23 6:10,1,5,1,0,3,2,5
2023/2/23 6:20,1,5,1,0,7,1,8
2023/2/23 6:30,1,5,1,0,7,2,9
2023/2/23 6:40,1,5,1,0,11,1,12
2023/2/23 6:50,1,5,1,0,38,0,38
2023/2/23 7:00,1,5,1,0,64,3,67
2023/2/23 7:10,1,5,1,0,91,2,93
2023/2/23 7:20,1,6,1,0,120,1,121
2023/2/23 7:30,1,6,1,0,305,0,305
2023/2/23 7:40,1,6,1,0,493,3,496
2023/2/23 7:50,1,6,1,0,612,5,617
2023/2/23 8:00,1,6,1,0,288,6,294
2023/2/23 8:10,1,6,1,0,148,11,159
2023/2/23 8:20,1,6,1,0,104,9,113
2023/2/23 8:30,1,6,1,0,91,13,104
2023/2/23 8:40,1,6,1,0,85,12,97
2023/2/23 8:50,1,6,1,0,81,10,91
2023/2/23 9:00,1,6,1,0,71,17,88
2023/2/23 9:10,1,6,1,0,77,15,92
2023/2/23 9:20,1,6,1,0,138,29,167
2023/2/23 9:30,1,6,1,0,243,41,284
2023/2/23 9:40,1,6,1,0,232,146,378
2023/2/23 9:50,1,6,1,0,168,183,351
2023/2/23 10:00,1,6,1,0,140,139,279
2023/2/23 10:10,1,7,1,0,80,109,189
2023/2/23 10:20,1,7,1,0,77,74,151
2023/2/23 10:30,1,7,1,0,54,53,107
2023/2/23 10:40,1,7,1,0,65,45,110
2023/2/23 10:50,1,7,1,0,65,42,107
2023/2/23 11:00,1,7,1,0,69,41,110
2023/2/23 11:10,1,7,1,0,69,35,104
2023/2/23 11:20,1,7,1,0,67,42,109
2023/2/23 11:30,1,7,1,0,61,69,130
2023/2/23 11:40,1,7,1,0,73,197,270
2023/2/23 11:50,1,7,1,0,73,253,326
2023/2/23 12:00,1,7,1,0,56,248,304
2023/2/23 12:10,1,7,1,0,54,182,236
2023/2/23 12:20,1,7,1,0,52,119,171
2023/2/23 12:30,1,7,1,0,61,94,155
2023/2/23 12:40,1,7,1,0,52,64,116
2023/2/23 12:50,1,7,1,0,58,54,112
2023/2/23 13:00,1,7,1,0,62,27,89
2023/2/23 13:10,1,7,1,0,67,29,96
2023/2/23 13:20,1,7,1,0,81,35,116
2023/2/23 13:30,1,7,1,0,145,30,175
2023/2/23 13:40,1,7,1,0,249,34,283
2023/2/23 13:50,1,7,1,0,235,34,269
2023/2/23 14:00,1,7,1,0,111,32,143
2023/2/23 14:10,1,7,1,0,109,36,145
2023/2/23 14:20,1,7,1,0,102,37,139
2023/2/23 14:30,1,7,1,0,89,40,129
2023/2/23 14:40,1,7,1,0,74,45,119
2023/2/23 14:50,1,7,1,0,74,45,119
2023/2/23 15:00,1,7,1,0,76,39,115
2023/2/23 15:10,1,7,1,0,83,37,120
2023/2/23 15:20,1,7,1,0,81,40,121
2023/2/23 15:30,1,7,1,0,83,66,149
2023/2/23 15:40,1,7,1,0,128,158,286
2023/2/23 15:50,1,7,1,0,141,243,384
2023/2/23 16:00,1,7,1,0,110,147,257
2023/2/23 16:10,1,7,1,0,90,124,214
2023/2/23 16:20,1,6,1,0,66,89,155
2023/2/23 16:30,1,6,1,0,78,78,156
2023/2/23 16:40,1,6,1,0,62,59,121
2023/2/23 16:50,1,6,1,0,83,56,139
2023/2/23 17:00,1,6,1,0,76,65,141
2023/2/23 17:10,1,6,1,0,68,57,125
2023/2/23 17:20,1,6,1,0,86,52,138
2023/2/23 17:30,1,6,1,0,91,76,167
2023/2/23 17:40,1,6,1,0,80,233,313
2023/2/23 17:50,1,6,1,0,106,241,347
2023/2/23 18:00,1,6,1,0,86,194,280
2023/2/23 18:10,1,6,1,0,90,141,231
2023/2/23 18:20,1,6,1,0,107,84,191
2023/2/23 18:30,1,6,1,0,110,95,205
2023/2/23 18:40,1,6,1,0,191,68,259
2023/2/23 18:50,1,6,1,0,172,60,232
2023/2/23 19:00,1,6,1,0,118,64,182
2023/2/23 19:10,1,6,1,0,109,56,165
2023/2/23 19:20,1,6,1,0,88,69,157
2023/2/23 19:30,1,6,1,0,90,66,156
2023/2/23 19:40,1,6,1,0,80,66,146
2023/2/23 19:50,1,6,1,0,90,63,153
2023/2/23 20:00,1,6,1,0,86,60,146
2023/2/23 20:10,1,6,1,0,82,69,151
2023/2/23 20:20,1,6,1,0,68,58,126
2023/2/23 20:30,1,6,1,0,66,86,152
2023/2/23 20:40,1,5,1,0,66,176,242
2023/2/23 20:50,1,5,1,0,59,248,307
2023/2/23 21:00,1,5,1,0,43,171,214
2023/2/23 21:10,1,5,1,0,54,134,188
2023/2/23 21:20,1,5,1,0,27,116,143
2023/2/23 21:30,1,5,1,0,26,74,100
2023/2/23 21:40,1,5,1,0,17,64,81
2023/2/23 21:50,1,5,1,0,20,77,97
2023/2/23 22:00,1,5,1,0,14,75,89
2023/2/23 22:10,1,5,1,0,14,82,96
2023/2/23 22:20,1,5,1,0,15,47,62
2023/2/23 22:30,1,5,1,0,14,34,48
2023/2/23 22:40,1,5,1,0,12,20,32
2023/2/23 22:50,1,5,1,0,12,11,23
2023/2/23 23:00,1,5,1,0,12,12,24
2023/2/23 23:10,1,5,1,0,7,10,17
2023/2/23 23:20,1,5,1,0,6,9,15
2023/2/23 23:30,1,5,1,0,1,10,11
2023/2/23 23:40,1,5,1,0,1,9,10
2023/2/23 23:50,1,5,1,0,1,3,4
2023/2/24 0:00,1,5,1,0,5,0,5
2023/2/24 0:10,1,5,1,0,2,1,3
2023/2/24 0:20,1,5,1,0,2,3,5
2023/2/24 0:30,1,5,1,0,0,0,0
2023/2/24 0:40,1,5,1,0,3,1,4
2023/2/24 0:50,1,4,1,0,2,2,4
2023/2/24 1:00,1,4,1,0,2,2,4
2023/2/24 1:10,1,4,1,0,1,1,2
2023/2/24 1:20,1,4,1,0,1,2,3
2023/2/24 1:30,1,4,1,0,1,0,1
2023/2/24 1:40,1,4,1,0,1,0,1
2023/2/24 1:50,1,4,1,0,2,2,4
2023/2/24 2:00,1,4,1,0,1,1,2
2023/2/24 2:10,1,4,1,0,0,1,1
2023/2/24 2:20,1,4,1,0,1,2,3
2023/2/24 2:30,1,4,1,0,2,0,2
2023/2/24 2:40,1,4,1,0,1,2,3
2023/2/24 2:50,1,4,1,0,0,0,0
2023/2/24 3:00,1,4,1,0,1,1,2
2023/2/24 3:10,1,4,1,0,0,0,0
2023/2/24 3:20,1,4,1,0,1,1,2
2023/2/24 3:30,1,4,1,0,0,2,2
2023/2/24 3:40,1,4,1,0,0,0,0
2023/2/24 3:50,1,4,1,0,2,0,2
2023/2/24 4:00,1,4,1,0,0,0,0
2023/2/24 4:10,1,4,1,0,1,1,2
2023/2/24 4:20,1,4,1,0,0,2,2
2023/2/24 4:30,1,4,1,0,0,0,0
2023/2/24 4:40,1,5,1,0,2,1,3
2023/2/24 4:50,1,5,1,0,2,1,3
2023/2/24 5:00,1,5,1,0,1,2,3
2023/2/24 5:10,1,5,1,0,0,1,1
2023/2/24 5:20,1,5,1,0,2,2,4
2023/2/24 5:30,1,5,1,0,3,1,4
2023/2/24 5:40,1,5,1,0,2,0,2
2023/2/24 5:50,1,5,1,0,5,1,6
2023/2/24 6:00,1,5,1,0,3,4,7
2023/2/24 6:10,1,5,1,0,3,3,6
2023/2/24 6:20,1,5,1,0,4,1,5
2023/2/24 6:30,1,5,1,0,5,3,8
2023/2/24 6:40,1,5,1,0,11,2,13
2023/2/24 6:50,1,6,1,0,42,2,44
2023/2/24 7:00,1,6,1,0,65,3,68
2023/2/24 7:10,1,6,1,0,82,1,83
2023/2/24 7:20,1,6,1,0,116,2,118
2023/2/24 7:30,1,6,1,0,332,1,333
2023/2/24 7:40,1,7,1,0,579,4,583
2023/2/24 7:50,1,7,1,0,607,4,611
2023/2/24 8:00,1,7,1,0,298,5,303
2023/2/24 8:10,1,7,1,0,149,9,158
2023/2/24 8:20,1,7,1,0,101,10,111
2023/2/24 8:30,1,7,1,0,78,12,90
2023/2/24 8:40,1,8,1,0,81,15,96
2023/2/24 8:50,1,8,1,0,75,12,87
2023/2/24 9:00,1,8,1,0,89,14,103
2023/2/24 9:10,1,9,1,0,79,17,96
2023/2/24 9:20,1,9,1,0,171,31,202
2023/2/24 9:30,1,9,1,0,231,44,275
2023/2/24 9:40,1,9,1,0,272,126,398
2023/2/24 9:50,1,9,1,0,203,187,390
2023/2/24 10:00,1,10,1,0,133,165,298
2023/2/24 10:10,1,10,1,0,78,88,166
2023/2/24 10:20,1,10,1,0,85,76,161
2023/2/24 10:30,1,10,1,0,65,48,113
2023/2/24 10:40,1,10,1,0,70,51,121
2023/2/24 10:50,1,11,1,0,70,44,114
2023/2/24 11:00,1,11,1,0,58,38,96
2023/2/24 11:10,1,11,1,0,59,33,92
2023/2/24 11:20,1,11,1,0,56,48,104
2023/2/24 11:30,1,11,1,0,64,75,139
2023/2/24 11:40,1,11,1,0,82,215,297
2023/2/24 11:50,1,11,1,0,68,269,337
2023/2/24 12:00,1,11,1,0,54,236,290
2023/2/24 12:10,1,11,1,0,53,201,254
2023/2/24 12:20,1,11,1,0,58,122,180
2023/2/24 12:30,1,11,1,0,62,96,158
2023/2/24 12:40,1,11,1,0,61,71,132
2023/2/24 12:50,1,10,1,0,58,45,103
2023/2/24 13:00,1,10,1,0,56,33,89
2023/2/24 13:10,1,10,1,0,54,30,84
2023/2/24 13:20,1,9,1,0,76,35,111
2023/2/24 13:30,1,9,1,0,154,37,191
2023/2/24 13:40,1,9,1,0,213,34,247
2023/2/24 13:50,1,9,1,0,263,42,305
2023/2/24 14:00,1,9,1,0,140,27,167
2023/2/24 14:10,1,9,1,0,110,40,150
2023/2/24 14:20,1,9,1,0,94,41,135
2023/2/24 14:30,1,9,1,0,95,47,142
2023/2/24 14:40,1,9,1,0,83,47,130
2023/2/24 14:50,1,9,1,0,71,45,116
2023/2/24 15:00,1,8,1,0,68,47,115
2023/2/24 15:10,1,8,1,0,82,37,119
2023/2/24 15:20,1,8,1,0,69,46,115
2023/2/24 15:30,1,8,1,0,87,58,145
2023/2/24 15:40,1,8,1,0,156,172,328
2023/2/24 15:50,1,7,1,0,151,225,376
2023/2/24 16:00,1,7,1,0,109,133,242
2023/2/24 16:10,1,7,1,0,84,112,196
2023/2/24 16:20,1,7,1,0,74,84,158
2023/2/24 16:30,1,7,1,0,69,76,145
2023/2/24 16:40,1,7,1,0,74,54,128
2023/2/24 16:50,1,7,1,0,69,55,124
2023/2/24 17:00,1,7,1,0,75,60,135
2023/2/24 17:10,1,7,1,0,67,57,124
2023/2/24 17:20,1,7,1,0,71,54,125
2023/2/24 17:30,1,7,1,0,85,86,171
2023/2/24 17:40,1,7,1,0,76,248,324
2023/2/24 17:50,1,7,1,0,109,283,392
2023/2/24 18:00,1,6,1,0,94,210,304
2023/2/24 18:10,1,6,1,0,90,125,215
2023/2/24 18:20,1,6,1,0,86,109,195
2023/2/24 18:30,1,6,1,0,125,93,218
2023/2/24 18:40,1,6,1,0,194,73,267
2023/2/24 18:50,1,6,1,0,174,61,235
2023/2/24 19:00,1,6,1,0,136,68,204
2023/2/24 19:10,1,6,1,0,132,66,198
2023/2/24 19:20,1,6,1,0,94,65,159
2023/2/24 19:30,1,6,1,0,93,56,149
2023/2/24 19:40,1,6,1,0,93,64,157
2023/2/24 19:50,1,5,1,0,87,61,148
2023/2/24 20:00,1,5,1,0,73,74,147
2023/2/24 20:10,1,5,1,0,83,56,139
2023/2/24 20:20,1,5,1,0,79,67,146
2023/2/24 20:30,1,5,1,0,63,87,150
2023/2/24 20:40,1,5,1,0,57,193,250
2023/2/24 20:50,1,5,1,0,49,215,264
2023/2/24 21:00,1,5,1,0,55,166,221
2023/2/24 21:10,1,5,1,0,56,138,194
2023/2/24 21:20,1,5,1,0,30,103,133
2023/2/24 21:30,1,5,1,0,20,70,90
2023/2/24 21:40,1,5,1,0,21,78,99
2023/2/24 21:50,1,5,1,0,19,86,105
2023/2/24 22:00,1,4,1,0,17,83,100
2023/2/24 22:10,1,4,1,0,15,72,87
2023/2/24 22:20,1,4,1,0,15,48,63
2023/2/24 22:30,1,4,1,0,15,35,50
2023/2/24 22:40,1,4,1,0,10,19,29
2023/2/24 22:50,1,4,1,0,9,13,22
2023/2/24 23:00,1,4,1,0,12,10,22
2023/2/24 23:10,1,4,1,0,6,13,19
2023/2/24 23:20,1,3,1,0,5,10,15
2023/2/24 23:30,1,3,1,0,1,7,8
2023/2/24 23:40,1,3,1,0,2,10,12
2023/2/24 23:50,1,3,1,0,0,4,4
2023/2/25 0:00,1,3,0,0,3,3,6
2023/2/25 0:10,1,3,0,0,0,2,2
2023/2/25 0:20,1,3,0,0,1,0,1
2023/2/25 0:30,1,2,0,0,0,1,1
2023/2/25 0:40,1,2,0,0,1,1,2
2023/2/25 0:50,1,2,0,0,1,1,2
2023/2/25 1:00,1,2,0,0,0,2,2
2023/2/25 1:10,1,2,0,0,1,1,2
2023/2/25 1:20,1,2,0,0,0,0,0
2023/2/25 1:30,1,2,0,0,2,0,2
2023/2/25 1:40,1,2,0,0,1,0,1
2023/2/25 1:50,1,2,0,0,2,2,4
2023/2/25 2:00,1,1,0,0,1,2,3
2023/2/25 2:10,1,1,0,0,2,0,2
2023/2/25 2:20,1,1,0,0,0,0,0
2023/2/25 2:30,1,1,0,0,0,1,1
2023/2/25 2:40,1,1,0,0,0,0,0
2023/2/25 2:50,1,1,0,0,2,2,4
2023/2/25 3:00,1,1,0,0,0,0,0
2023/2/25 3:10,1,1,0,0,1,0,1
2023/2/25 3:20,1,1,0,0,2,2,4
2023/2/25 3:30,1,1,0,0,0,1,1
2023/2/25 3:40,1,1,0,0,2,0,2
2023/2/25 3:50,1,1,0,0,1,2,3
2023/2/25 4:00,1,1,0,0,2,2,4
2023/2/25 4:10,1,1,0,0,0,2,2
2023/2/25 4:20,1,1,0,0,2,2,4
2023/2/25 4:30,1,1,0,0,2,2,4
2023/2/25 4:40,1,2,0,0,1,1,2
2023/2/25 4:50,1,2,0,0,0,0,0
2023/2/25 5:00,1,2,0,0,2,1,3
2023/2/25 5:10,1,2,0,0,2,0,2
2023/2/25 5:20,1,2,0,0,2,1,3
2023/2/25 5:30,1,2,0,0,0,0,0
2023/2/25 5:40,1,2,0,0,3,1,4
2023/2/25 5:50,1,3,0,0,3,1,4
2023/2/25 6:00,1,3,0,0,5,1,6
2023/2/25 6:10,1,3,0,0,6,1,7
2023/2/25 6:20,1,3,0,0,8,1,9
2023/2/25 6:30,1,4,0,0,11,2,13
2023/2/25 6:40,1,4,0,0,13,0,13
2023/2/25 6:50,1,4,0,0,10,4,14
2023/2/25 7:00,1,4,0,0,13,0,13
2023/2/25 7:10,1,4,0,0,21,1,22
2023/2/25 7:20,1,5,0,0,37,2,39
2023/2/25 7:30,1,5,0,0,51,3,54
2023/2/25 7:40,1,5,0,0,58,2,60
2023/2/25 7:50,1,5,0,0,49,1,50
2023/2/25 8:00,1,5,0,0,49,4,53
2023/2/25 8:10,1,6,0,0,36,2,38
2023/2/25 8:20,1,6,0,0,34,0,34
2023/2/25 8:30,1,6,0,0,37,1,38
2023/2/25 8:40,1,6,0,0,28,4,32
2023/2/25 8:50,1,6,0,0,31,5,36
2023/2/25 9:00,1,6,0,0,29,2,31
2023/2/25 9:10,1,6,0,0,30,5,35
2023/2/25 9:20,1,6,0,0,37,7,44
2023/2/25 9:30,1,6,0,0,39,16,55
2023/2/25 9:40,1,6,0,0,34,14,48
2023/2/25 9:50,1,6,0,0,44,10,54
2023/2/25 10:00,1,7,0,0,30,17,47
2023/2/25 10:10,1,7,0,0,27,10,37
2023/2/25 10:20,1,7,0,0,22,9,31
2023/2/25 10:30,1,7,0,0,23,12,35
2023/2/25 10:40,1,7,0,0,18,16,34
2023/2/25 10:50,1,8,0,0,17,16,33
2023/2/25 11:00,1,8,0,0,14,19,33
2023/2/25 11:10,1,8,0,0,19,17,36
2023/2/25 11:20,1,9,0,0,13,20,33
2023/2/25 11:30,1,9,0,0,14,22,36
2023/2/25 11:40,1,9,0,0,9,25,34
2023/2/25 11:50,1,10,0,0,12,35,47
2023/2/25 12:00,1,10,0,0,13,31,44
2023/2/25 12:10,1,10,0,0,14,31,45
2023/2/25 12:20,1,10,0,0,11,25,36
2023/2/25 12:30,1,10,0,0,17,28,45
2023/2/25 12:40,1,10,0,0,12,32,44
2023/2/25 12:50,1,10,0,0,11,30,41
2023/2/25 13:00,1,10,0,0,9,23,32
2023/2/25 13:10,1,11,0,0,12,19,31
2023/2/25 13:20,1,11,0,0,16,16,32
2023/2/25 13:30,1,11,0,0,15,14,29
2023/2/25 13:40,1,11,0,0,26,18,44
2023/2/25 13:50,1,12,0,0,26,18,44
2023/2/25 14:00,1,12,0,0,21,17,38
2023/2/25 14:10,1,12,0,0,16,22,38
2023/2/25 14:20,1,12,0,0,18,17,35
2023/2/25 14:30,1,12,0,0,17,18,35
2023/2/25 14:40,1,12,0,0,17,12,29
2023/2/25 14:50,1,12,0,0,17,12,29
2023/2/25 15:00,1,12,0,0,22,9,31
2023/2/25 15:10,1,12,0,0,26,13,39
2023/2/25 15:20,1,13,0,0,22,16,38
2023/2/25 15:30,1,13,0,0,25,17,42
2023/2/25 15:40,1,13,0,0,21,19,40
2023/2/25 15:50,1,13,0,0,29,19,48
2023/2/25 16:00,1,13,0,0,26,17,43
2023/2/25 16:10,1,13,0,0,21,18,39
2023/2/25 16:20,1,13,0,0,26,15,41
2023/2/25 16:30,1,13,0,0,31,13,44
2023/2/25 16:40,1,13,0,0,27,10,37
2023/2/25 16:50,1,13,0,0,34,16,50
2023/2/25 17:00,1,13,0,0,34,15,49
2023/2/25 17:10,1,14,0,0,28,22,50
2023/2/25 17:20,1,14,0,0,38,23,61
2023/2/25 17:30,1,14,0,0,32,27,59
2023/2/25 17:40,1,14,0,0,35,30,65
2023/2/25 17:50,1,14,0,0,41,30,71
2023/2/25 18:00,1,14,0,0,48,34,82
2023/2/25 18:10,1,14,0,0,38,28,66
2023/2/25 18:20,1,14,0,0,49,29,78
2023/2/25 18:30,1,14,0,0,40,27,67
2023/2/25 18:40,1,14,0,0,42,29,71
2023/2/25 18:50,1,13,0,0,36,31,67
2023/2/25 19:00,1,12,0,0,32,23,55
2023/2/25 19:10,1,12,0,0,30,19,49
2023/2/25 19:20,1,12,0,0,27,20,47
2023/2/25 19:30,1,12,0,0,24,16,40
2023/2/25 19:40,1,12,0,0,28,19,47
2023/2/25 19:50,1,12,0,0,21,16,37
2023/2/25 20:00,1,12,0,0,21,22,43
2023/2/25 20:10,1,12,0,0,20,23,43
2023/2/25 20:20,1,12,0,0,18,22,40
2023/2/25 20:30,1,11,0,0,17,27,44
2023/2/25 20:40,1,11,0,0,16,26,42
2023/2/25 20:50,1,11,0,0,17,29,46
2023/2/25 21:00,1,11,0,0,10,32,42
2023/2/25 21:10,1,11,0,0,13,29,42
2023/2/25 21:20,1,10,0,0,12,26,38
2023/2/25 21:30,1,10,0,0,11,25,36
2023/2/25 21:40,1,10,0,0,9,40,49
2023/2/25 21:50,1,10,0,0,8,40,48
2023/2/25 22:00,1,10,0,0,4,41,45
2023/2/25 22:10,1,10,0,0,3,31,34
2023/2/25 22:20,1,10,0,0,4,28,32
2023/2/25 22:30,1,9,0,0,3,16,19
2023/2/25 22:40,1,9,0,0,2,14,16
2023/2/25 22:50,1,9,0,0,4,10,14
2023/2/25 23:00,1,9,0,0,3,4,7
2023/2/25 23:10,1,8,0,0,3,3,6
2023/2/25 23:20,1,8,0,0,0,3,3
2023/2/25 23:30,1,7,0,0,2,2,4
2023/2/25 23:40,1,7,0,0,1,1,2
2023/2/25 23:50,1,7,0,0,1,0,1
2023/2/26 0:00,1,7,0,0,3,3,6
2023/2/26 0:10,1,7,0,0,2,1,3
2023/2/26 0:20,1,6,0,0,2,0,2
2023/2/26 0:30,1,6,0,0,0,2,2
2023/2/26 0:40,1,6,0,0,1,2,3
2023/2/26 0:50,1,6,0,0,0,1,1
2023/2/26 1:00,1,6,0,0,1,1,2
2023/2/26 1:10,1,6,0,0,2,1,3
2023/2/26 1:20,1,6,0,0,0,0,0
2023/2/26 1:30,1,5,0,0,0,0,0
2023/2/26 1:40,1,5,0,0,0,0,0
2023/2/26 1:50,1,4,0,0,2,2,4
2023/2/26 2:00,1,4,0,0,2,1,3
2023/2/26 2:10,1,4,0,0,2,2,4
2023/2/26 2:20,1,4,0,0,1,2,3
2023/2/26 2:30,1,4,0,0,0,2,2
2023/2/26 2:40,1,4,0,0,1,2,3
2023/2/26 2:50,1,4,0,0,0,0,0
2023/2/26 3:00,1,4,0,0,2,2,4
2023/2/26 3:10,1,4,0,0,2,2,4
2023/2/26 3:20,1,4,0,0,1,1,2
2023/2/26 3:30,1,4,0,0,1,1,2
2023/2/26 3:40,1,4,0,0,2,0,2
2023/2/26 3:50,1,4,0,0,0,2,2
2023/2/26 4:00,1,4,0,0,2,0,2
2023/2/26 4:10,1,4,0,0,0,1,1
2023/2/26 4:20,1,4,0,0,1,1,2
2023/2/26 4:30,1,5,0,0,1,0,1
2023/2/26 4:40,1,5,0,0,0,0,0
2023/2/26 4:50,1,5,0,0,2,1,3
2023/2/26 5:00,1,5,0,0,2,0,2
2023/2/26 5:10,1,5,0,0,2,1,3
2023/2/26 5:20,1,6,0,0,3,2,5
2023/2/26 5:30,1,6,0,0,0,1,1
2023/2/26 5:40,1,6,0,0,1,1,2
2023/2/26 5:50,1,6,0,0,4,1,5
2023/2/26 6:00,1,7,0,0,5,1,6
2023/2/26 6:10,1,7,0,0,8,0,8
2023/2/26 6:20,1,7,0,0,6,1,7
2023/2/26 6:30,1,7,0,0,8,3,11
2023/2/26 6:40,1,7,0,0,9,2,11
2023/2/26 6:50,1,7,0,0,8,2,10
2023/2/26 7:00,1,7,0,0,13,0,13
2023/2/26 7:10,1,7,0,0,23,3,26
2023/2/26 7:20,1,7,0,0,44,2,46
2023/2/26 7:30,1,7,0,0,51,4,55
2023/2/26 7:40,1,7,0,0,60,3,63
2023/2/26 7:50,1,7,0,0,58,2,60
2023/2/26 8:00,1,8,0,0,40,6,46
2023/2/26 8:10,1,8,0,0,37,3,40
2023/2/26 8:20,1,8,0,0,33,0,33
2023/2/26 8:30,1,8,0,0,38,3,41
2023/2/26 8:40,1,8,0,0,29,5,34
2023/2/26 8:50,1,8,0,0,35,3,38
2023/2/26 9:00,1,8,0,0,35,2,37
2023/2/26 9:10,1,8,0,0,37,4,41
2023/2/26 9:20,1,8,0,0,30,7,37
2023/2/26 9:30,1,8,0,0,31,16,47
2023/2/26 9:40,1,8,0,0,41,16,57
2023/2/26 9:50,1,8,0,0,44,9,53
2023/2/26 10:00,1,9,0,0,32,19,51
2023/2/26 10:10,1,9,0,0,24,13,37
2023/2/26 10:20,1,9,0,0,21,11,32
2023/2/26 10:30,1,9,0,0,21,13,34
2023/2/26 10:40,1,9,0,0,18,14,32
2023/2/26 10:50,1,9,0,0,18,19,37
2023/2/26 11:00,1,10,0,0,14,16,30
2023/2/26 11:10,1,10,0,0,14,20,34
2023/2/26 11:20,1,10,0,0,13,21,34
2023/2/26 11:30,1,10,0,0,14,23,37
2023/2/26 11:40,1,11,0,0,9,22,31
2023/2/26 11:50,1,11,0,0,12,30,42
2023/2/26 12:00,1,11,0,0,12,33,45
2023/2/26 12:10,1,11,0,0,13,31,44
2023/2/26 12:20,1,11,0,0,10,27,37
2023/2/26 12:30,1,11,0,0,16,34,50
2023/2/26 12:40,1,12,0,0,13,32,45
2023/2/26 12:50,1,12,0,0,8,27,35
2023/2/26 13:00,1,12,0,0,12,23,35
2023/2/26 13:10,1,12,0,0,11,19,30
2023/2/26 13:20,1,12,0,0,15,14,29
2023/2/26 13:30,1,13,0,0,17,17,34
2023/2/26 13:40,1,13,0,0,25,17,42
2023/2/26 13:50,1,13,0,0,25,21,46
2023/2/26 14:00,1,13,0,0,20,17,37
2023/2/26 14:10,1,14,0,0,18,23,41
2023/2/26 14:20,1,14,0,0,14,14,28
2023/2/26 14:30,1,14,0,0,16,17,33
2023/2/26 14:40,1,14,0,0,15,13,28
2023/2/26 14:50,1,15,0,0,16,12,28
2023/2/26 15:00,1,15,0,0,22,13,35
2023/2/26 15:10,1,15,0,0,21,13,34
2023/2/26 15:20,1,15,0,0,24,12,36
2023/2/26 15:30,1,15,0,0,27,15,42
2023/2/26 15:40,1,15,0,0,25,21,46
2023/2/26 15:50,1,16,0,0,30,15,45
2023/2/26 16:00,1,16,0,0,22,14,36
2023/2/26 16:10,1,16,0,0,26,14,40
2023/2/26 16:20,1,16,0,0,29,14,43
2023/2/26 16:30,1,16,0,0,28,12,40
2023/2/26 16:40,1,16,0,0,25,11,36
2023/2/26 16:50,1,16,0,0,34,15,49
2023/2/26 17:00,1,16,0,0,31,17,48
2023/2/26 17:10,1,16,0,0,31,23,54
2023/2/26 17:20,1,16,0,0,34,20,54
2023/2/26 17:30,1,16,0,0,39,21,60
2023/2/26 17:40,1,16,0,0,32,35,67
2023/2/26 17:50,1,16,0,0,38,31,69
2023/2/26 18:00,1,16,0,0,43,36,79
2023/2/26 18:10,1,16,0,0,45,34,79
2023/2/26 18:20,1,15,0,0,45,25,70
2023/2/26 18:30,1,15,0,0,44,27,71
2023/2/26 18:40,1,15,0,0,37,24,61
2023/2/26 18:50,1,15,0,0,37,30,67
2023/2/26 19:00,1,15,0,0,32,22,54
2023/2/26 19:10,1,14,0,0,29,23,52
2023/2/26 19:20,1,14,0,0,24,21,45
2023/2/26 19:30,1,14,0,0,20,20,40
2023/2/26 19:40,1,14,0,0,25,17,42
2023/2/26 19:50,1,14,0,0,21,17,38
2023/2/26 20:00,1,14,0,0,22,20,42
2023/2/26 20:10,1,14,0,0,15,19,34
2023/2/26 20:20,1,13,0,0,14,26,40
2023/2/26 20:30,1,13,0,0,15,25,40
2023/2/26 20:40,1,13,0,0,17,33,50
2023/2/26 20:50,1,13,0,0,13,30,43
2023/2/26 21:00,1,13,0,0,12,36,48
2023/2/26 21:10,1,13,0,0,15,30,45
2023/2/26 21:20,1,12,0,0,12,23,35
2023/2/26 21:30,1,12,0,0,9,20,29
2023/2/26 21:40,1,12,0,0,9,35,44
2023/2/26 21:50,1,12,0,0,7,43,50
2023/2/26 22:00,1,12,0,0,5,33,38
2023/2/26 22:10,1,12,0,0,4,30,34
2023/2/26 22:20,1,12,0,0,4,31,35
2023/2/26 22:30,1,11,0,0,3,17,20
2023/2/26 22:40,1,11,0,0,3,11,14
2023/2/26 22:50,1,11,0,0,2,9,11
2023/2/26 23:00,1,11,0,0,3,4,7
2023/2/26 23:10,1,11,0,0,3,6,9
2023/2/26 23:20,1,10,0,0,0,2,2
2023/2/26 23:30,1,10,0,0,2,2,4
2023/2/26 23:40,1,10,0,0,1,1,2
2023/2/26 23:50,1,10,0,0,2,2,4
2023/2/27 0:00,1,10,1,0,5,2,7
2023/2/27 0:10,1,10,1,0,2,1,3
2023/2/27 0:20,1,10,1,0,2,1,3
2023/2/27 0:30,1,10,1,0,2,2,4
2023/2/27 0:40,1,9,1,0,2,2,4
2023/2/27 0:50,1,9,1,0,2,1,3
2023/2/27 1:00,1,9,1,0,0,0,0
2023/2/27 1:10,1,8,1,0,2,1,3
2023/2/27 1:20,1,8,1,0,2,0,2
2023/2/27 1:30,1,8,1,0,2,1,3
2023/2/27 1:40,1,8,1,0,0,0,0
2023/2/27 1:50,1,7,1,0,1,2,3
2023/2/27 2:00,1,7,1,0,1,0,1
2023/2/27 2:10,1,7,1,0,0,0,0
2023/2/27 2:20,1,7,1,0,0,2,2
2023/2/27 2:30,1,7,1,0,2,0,2
2023/2/27 2:40,1,6,1,0,1,0,1
2023/2/27 2:50,1,6,1,0,1,1,2
2023/2/27 3:00,1,6,1,0,0,1,1
2023/2/27 3:10,1,6,1,0,0,1,1
2023/2/27 3:20,1,6,1,0,0,0,0
2023/2/27 3:30,1,6,1,0,1,1,2
2023/2/27 3:40,1,6,1,0,2,1,3
2023/2/27 3:50,1,6,1,0,2,2,4
2023/2/27 4:00,1,6,1,0,1,1,2
2023/2/27 4:10,1,6,1,0,2,2,4
2023/2/27 4:20,1,6,1,0,0,0,0
2023/2/27 4:30,1,6,1,0,0,2,2
2023/2/27 4:40,1,7,1,0,0,2,2
2023/2/27 4:50,1,7,1,0,2,0,2
2023/2/27 5:00,1,7,1,0,2,2,4
2023/2/27 5:10,1,7,1,0,1,2,3
2023/2/27 5:20,1,7,1,0,0,0,0
2023/2/27 5:30,1,7,1,0,3,2,5
2023/2/27 5:40,1,8,1,0,0,0,0
2023/2/27 5:50,1,8,1,0,3,2,5
2023/2/27 6:00,1,8,1,0,4,3,7
2023/2/27 6:10,1,8,1,0,4,2,6
2023/2/27 6:20,1,8,1,0,6,3,9
2023/2/27 6:30,1,8,1,0,4,4,8
2023/2/27 6:40,1,9,1,0,11,0,11
2023/2/27 6:50,1,9,1,0,43,2,45
2023/2/27 7:00,1,9,1,0,57,2,59
2023/2/27 7:10,1,10,1,0,81,2,83
2023/2/27 7:20,1,10,1,0,97,1,98
2023/2/27 7:30,1,10,1,0,340,0,340
2023/2/27 7:40,1,10,1,0,537,3,540
2023/2/27 7:50,1,11,1,0,615,3,618
2023/2/27 8:00,1,11,1,0,316,5,321
2023/2/27 8:10,1,11,1,0,154,9,163
2023/2/27 8:20,1,11,1,0,83,11,94
2023/2/27 8:30,1,11,1,0,82,11,93
2023/2/27 8:40,1,11,1,0,82,13,95
2023/2/27 8:50,1,11,1,0,70,13,83
2023/2/27 9:00,1,11,1,0,72,15,87
2023/2/27 9:10,1,11,1,0,82,20,102
2023/2/27 9:20,1,12,1,0,142,32,174
2023/2/27 9:30,1,12,1,0,218,39,257
2023/2/27 9:40,1,12,1,0,271,134,405
2023/2/27 9:50,1,12,1,0,215,169,384
2023/2/27 10:00,1,12,1,0,149,152,301
2023/2/27 10:10,1,12,1,0,89,89,178
2023/2/27 10:20,1,12,1,0,77,62,139
2023/2/27 10:30,1,12,1,0,59,50,109
2023/2/27 10:40,1,13,1,0,59,46,105
2023/2/27 10:50,1,13,1,0,76,40,116
2023/2/27 11:00,1,13,1,0,70,35,105
2023/2/27 11:10,1,13,1,0,68,39,107
2023/2/27 11:20,1,13,1,0,66,49,115
2023/2/27 11:30,1,13,1,0,75,64,139
2023/2/27 11:40,1,14,1,0,69,244,313
2023/2/27 11:50,1,14,1,0,74,290,364
2023/2/27 12:00,1,14,1,0,58,227,285
2023/2/27 12:10,1,14,1,0,60,163,223
2023/2/27 12:20,1,14,1,0,53,128,181
2023/2/27 12:30,1,14,1,0,56,86,142
2023/2/27 12:40,1,14,1,0,64,64,128
2023/2/27 12:50,1,15,1,0,57,56,113
2023/2/27 13:00,1,15,1,0,63,27,90
2023/2/27 13:10,1,15,1,0,55,30,85
2023/2/27 13:20,1,16,1,0,76,30,106
2023/2/27 13:30,1,16,1,0,174,30,204
2023/2/27 13:40,1,16,1,0,260,34,294
2023/2/27 13:50,1,16,1,0,218,32,250
2023/2/27 14:00,1,16,1,0,116,34,150
2023/2/27 14:10,1,17,1,0,95,44,139
2023/2/27 14:20,1,17,1,0,105,43,148
2023/2/27 14:30,1,17,1,0,79,40,119
2023/2/27 14:40,1,17,1,0,74,38,112
2023/2/27 14:50,1,17,1,0,79,46,125
2023/2/27 15:00,1,17,1,0,66,44,110
2023/2/27 15:10,1,18,1,0,71,41,112
2023/2/27 15:20,1,18,1,0,86,38,124
2023/2/27 15:30,1,18,1,0,80,72,152
2023/2/27 15:40,1,18,1,0,149,191,340
2023/2/27 15:50,1,18,1,0,139,201,340
2023/2/27 16:00,1,18,1,0,93,160,253
2023/2/27 16:10,1,18,1,0,91,113,204
2023/2/27 16:20,1,18,1,0,83,73,156
2023/2/27 16:30,1,18,1,0,65,65,130
2023/2/27 16:40,1,18,1,0,76,56,132
2023/2/27 16:50,1,18,1,0,66,63,129
2023/2/27 17:00,1,18,1,0,67,59,126
2023/2/27 17:10,1,17,1,0,72,55,127
2023/2/27 17:20,1,17,1,0,71,54,125
2023/2/27 17:30,1,17,1,0,76,80,156
2023/2/27 17:40,1,16,1,0,84,250,334
2023/2/27 17:50,1,16,1,0,104,247,351
2023/2/27 18:00,1,16,1,0,102,226,328
2023/2/27 18:10,1,16,1,0,79,148,227
2023/2/27 18:20,1,16,1,0,105,100,205
2023/2/27 18:30,1,16,1,0,102,82,184
2023/2/27 18:40,1,16,1,0,178,67,245
2023/2/27 18:50,1,16,1,0,165,63,228
2023/2/27 19:00,1,16,1,0,133,55,188
2023/2/27 19:10,1,15,1,0,130,68,198
2023/2/27 19:20,1,15,1,0,90,64,154
2023/2/27 19:30,1,15,1,0,91,68,159
2023/2/27 19:40,1,15,1,0,79,64,143
2023/2/27 19:50,1,14,1,0,93,61,154
2023/2/27 20:00,1,14,1,0,90,62,152
2023/2/27 20:10,1,14,1,0,80,55,135
2023/2/27 20:20,1,14,1,0,74,70,144
2023/2/27 20:30,1,14,1,0,69,106,175
2023/2/27 20:40,1,14,1,0,62,176,238
2023/2/27 20:50,1,14,1,0,58,244,302
2023/2/27 21:00,1,13,1,0,55,162,217
2023/2/27 21:10,1,13,1,0,46,147,193
2023/2/27 21:20,1,13,1,0,27,103,130
2023/2/27 21:30,1,13,1,0,22,67,89
2023/2/27 21:40,1,13,1,0,16,71,87
2023/2/27 21:50,1,13,1,0,18,83,101
2023/2/27 22:00,1,13,1,0,15,80,95
2023/2/27 22:10,1,13,1,0,13,84,97
2023/2/27 22:20,1,13,1,0,14,48,62
2023/2/27 22:30,1,12,1,0,15,30,45
2023/2/27 22:40,1,12,1,0,10,20,30
2023/2/27 22:50,1,12,1,0,12,13,25
2023/2/27 23:00,1,12,1,0,10,10,20
2023/2/27 23:10,1,12,1,0,7,12,19
2023/2/27 23:20,1,12,1,0,4,10,14
2023/2/27 23:30,1,12,1,0,2,7,9
2023/2/27 23:40,1,12,1,0,2,11,13
2023/2/27 23:50,1,12,1,0,1,5,6
2023/2/28 0:00,1,12,1,0,5,1,6
2023/2/28 0:10,1,11,1,0,2,2,4
2023/2/28 0:20,1,11,1,0,2,2,4
2023/2/28 0:30,1,11,1,0,1,2,3
2023/2/28 0:40,1,11,1,0,3,2,5
2023/2/28 0:50,1,11,1,0,1,2,3
2023/2/28 1:00,1,11,1,0,2,1,3
2023/2/28 1:10,1,11,1,0,0,1,1
2023/2/28 1:20,1,11,1,0,2,0,2
2023/2/28 1:30,1,10,1,0,0,1,1
2023/2/28 1:40,1,10,1,0,1,2,3
2023/2/28 1:50,1,10,1,0,1,1,2
2023/2/28 2:00,1,10,1,0,0,2,2
2023/2/28 2:10,1,10,1,0,0,1,1
2023/2/28 2:20,1,10,1,0,0,2,2
2023/2/28 2:30,1,10,1,0,2,0,2
2023/2/28 2:40,1,9,1,0,0,2,2
2023/2/28 2:50,1,9,1,0,0,1,1
2023/2/28 3:00,1,9,1,0,2,1,3
2023/2/28 3:10,1,9,1,0,2,0,2
2023/2/28 3:20,1,9,1,0,1,0,1
2023/2/28 3:30,1,9,1,0,2,0,2
2023/2/28 3:40,1,9,1,0,0,1,1
2023/2/28 3:50,1,9,1,0,1,2,3
2023/2/28 4:00,1,9,1,0,1,2,3
2023/2/28 4:10,1,9,1,0,0,0,0
2023/2/28 4:20,1,9,1,0,2,2,4
2023/2/28 4:30,1,9,1,0,1,2,3
2023/2/28 4:40,1,9,1,0,0,2,2
2023/2/28 4:50,1,9,1,0,1,0,1
2023/2/28 5:00,1,9,1,0,2,1,3
2023/2/28 5:10,1,9,1,0,2,2,4
2023/2/28 5:20,1,9,1,0,2,1,3
2023/2/28 5:30,1,9,1,0,1,0,1
2023/2/28 5:40,1,9,1,0,2,1,3
2023/2/28 5:50,1,9,1,0,5,1,6
2023/2/28 6:00,1,9,1,0,2,2,4
2023/2/28 6:10,1,10,1,0,3,2,5
2023/2/28 6:20,1,10,1,0,6,2,8
2023/2/28 6:30,1,10,1,0,7,3,10
2023/2/28 6:40,1,10,1,0,12,2,14
2023/2/28 6:50,1,10,1,0,42,2,44
2023/2/28 7:00,1,11,1,0,68,3,71
2023/2/28 7:10,1,11,1,0,101,0,101
2023/2/28 7:20,1,11,1,0,119,2,121
2023/2/28 7:30,1,11,1,0,328,0,328
2023/2/28 7:40,1,11,1,0,605,3,608
2023/2/28 7:50,1,11,1,0,641,6,647
2023/2/28 8:00,1,11,1,0,282,5,287
2023/2/28 8:10,1,11,1,0,123,11,134
2023/2/28 8:20,1,12,1,0,91,8,99
2023/2/28 8:30,1,12,1,0,92,13,105
2023/2/28 8:40,1,12,1,0,86,12,98
2023/2/28 8:50,1,12,1,0,65,12,77
2023/2/28 9:00,1,12,1,0,80,16,96
2023/2/28 9:10,1,12,1,0,84,18,102
2023/2/28 9:20,1,12,1,0,157,28,185
2023/2/28 9:30,1,12,1,0,213,42,255
2023/2/28 9:40,1,12,1,0,264,136,400
2023/2/28 9:50,1,12,1,0,189,167,356
2023/2/28 10:00,1,12,1,0,147,164,311
2023/2/28 10:10,1,13,1,0,74,109,183
2023/2/28 10:20,1,13,1,0,84,75,159
2023/2/28 10:30,1,13,1,0,59,51,110
2023/2/28 10:40,1,13,1,0,69,50,119
2023/2/28 10:50,1,13,1,0,73,44,117
2023/2/28 11:00,1,13,1,0,62,35,97
2023/2/28 11:10,1,13,1,0,59,41,100
2023/2/28 11:20,1,13,1,0,64,45,109
2023/2/28 11:30,1,13,1,0,78,67,145
2023/2/28 11:40,1,13,1,0,78,228,306
2023/2/28 11:50,1,14,1,0,71,284,355
2023/2/28 12:00,1,14,1,0,52,288,340
2023/2/28 12:10,1,14,1,0,58,181,239
2023/2/28 12:20,1,14,1,0,59,124,183
2023/2/28 12:30,1,15,1,0,56,81,137
2023/2/28 12:40,1,15,1,0,58,59,117
2023/2/28 12:50,1,15,1,0,62,51,113
2023/2/28 13:00,1,15,1,0,69,32,101
2023/2/28 13:10,1,15,1,0,59,30,89
2023/2/28 13:20,1,15,1,0,92,36,128
2023/2/28 13:30,1,15,1,0,184,32,216
2023/2/28 13:40,1,15,1,0,267,34,301
2023/2/28 13:50,1,15,1,0,274,35,309
2023/2/28 14:00,1,15,1,0,121,27,148
2023/2/28 14:10,1,15,1,0,99,38,137
2023/2/28 14:20,1,15,1,0,105,44,149
2023/2/28 14:30,1,15,1,0,94,45,139
2023/2/28 14:40,1,15,1,0,72,49,121
2023/2/28 14:50,1,15,1,0,73,38,111
2023/2/28 15:00,1,15,1,0,64,45,109
2023/2/28 15:10,1,16,1,0,66,46,112
2023/2/28 15:20,1,16,1,0,77,45,122
2023/2/28 15:30,1,16,1,0,89,71,160
2023/2/28 15:40,1,16,1,0,146,178,324
2023/2/28 15:50,1,16,1,0,140,238,378
2023/2/28 16:00,1,16,1,0,107,163,270
2023/2/28 16:10,1,16,1,0,96,104,200
2023/2/28 16:20,1,16,1,0,80,78,158
2023/2/28 16:30,1,16,1,0,78,73,151
2023/2/28 16:40,1,16,1,0,68,63,131
2023/2/28 16:50,1,16,1,0,65,67,132
2023/2/28 17:00,1,16,1,0,72,64,136
2023/2/28 17:10,1,16,1,0,71,51,122
2023/2/28 17:20,1,15,1,0,74,50,124
2023/2/28 17:30,1,15,1,0,86,91,177
2023/2/28 17:40,1,15,1,0,98,238,336
2023/2/28 17:50,1,15,1,0,106,268,374
2023/2/28 18:00,1,15,1,0,100,211,311
2023/2/28 18:10,1,15,1,0,78,136,214
2023/2/28 18:20,1,15,1,0,92,95,187
2023/2/28 18:30,1,15,1,0,102,80,182
2023/2/28 18:40,1,15,1,0,194,73,267
2023/2/28 18:50,1,15,1,0,153,74,227
2023/2/28 19:00,1,15,1,0,129,57,186
2023/2/28 19:10,1,15,1,0,126,62,188
2023/2/28 19:20,1,14,1,0,110,66,176
2023/2/28 19:30,1,14,1,0,83,54,137
2023/2/28 19:40,1,14,1,0,84,56,140
2023/2/28 19:50,1,14,1,0,91,62,153
2023/2/28 20:00,1,14,1,0,84,68,152
2023/2/28 20:10,1,14,1,0,83,56,139
2023/2/28 20:20,1,14,1,0,79,59,138
2023/2/28 20:30,1,14,1,0,71,103,174
2023/2/28 20:40,1,14,1,0,65,212,277
2023/2/28 20:50,1,14,1,0,58,231,289
2023/2/28 21:00,1,14,1,0,53,161,214
2023/2/28 21:10,1,14,1,0,44,139,183
2023/2/28 21:20,1,14,1,0,31,102,133
2023/2/28 21:30,1,14,1,0,20,66,86
2023/2/28 21:40,1,14,1,0,20,66,86
2023/2/28 21:50,1,14,1,0,18,73,91
2023/2/28 22:00,1,14,1,0,16,85,101
2023/2/28 22:10,1,13,1,0,15,68,83
2023/2/28 22:20,1,13,1,0,17,43,60
2023/2/28 22:30,1,13,1,0,13,37,50
2023/2/28 22:40,1,13,1,0,9,20,29
2023/2/28 22:50,1,12,1,0,12,11,23
2023/2/28 23:00,1,12,1,0,9,12,21
2023/2/28 23:10,1,12,1,0,6,10,16
2023/2/28 23:20,1,12,1,0,7,10,17
2023/2/28 23:30,1,12,1,0,3,8,11
2023/2/28 23:40,1,12,1,0,1,9,10
2023/2/28 23:50,1,12,1,0,1,5,6
2023/3/1 0:00,1,12,1,0,4,2,6
2023/3/1 0:10,1,12,1,0,2,0,2
2023/3/1 0:20,1,12,1,0,2,3,5
2023/3/1 0:30,1,12,1,0,1,1,2
2023/3/1 0:40,1,11,1,0,2,0,2
2023/3/1 0:50,1,11,1,0,2,1,3
2023/3/1 1:00,1,11,1,0,1,0,1
2023/3/1 1:10,1,11,1,0,1,2,3
2023/3/1 1:20,1,11,1,0,1,2,3
2023/3/1 1:30,1,11,1,0,0,0,0
2023/3/1 1:40,1,11,1,0,2,0,2
2023/3/1 1:50,1,11,1,0,1,1,2
2023/3/1 2:00,1,11,1,0,2,2,4
2023/3/1 2:10,1,10,1,0,0,0,0
2023/3/1 2:20,1,10,1,0,2,1,3
2023/3/1 2:30,1,10,1,0,2,0,2
2023/3/1 2:40,1,10,1,0,1,2,3
2023/3/1 2:50,1,10,1,0,1,2,3
2023/3/1 3:00,1,10,1,0,2,1,3
2023/3/1 3:10,1,10,1,0,1,0,1
2023/3/1 3:20,1,10,1,0,0,0,0
2023/3/1 3:30,1,10,1,0,0,2,2
2023/3/1 3:40,1,10,1,0,1,1,2
2023/3/1 3:50,1,10,1,0,2,0,2
2023/3/1 4:00,1,10,1,0,1,2,3
2023/3/1 4:10,1,10,1,0,1,0,1
2023/3/1 4:20,1,10,1,0,0,2,2
2023/3/1 4:30,1,10,1,0,0,1,1
2023/3/1 4:40,1,10,1,0,0,0,0
2023/3/1 4:50,1,10,1,0,0,0,0
2023/3/1 5:00,1,10,1,0,0,1,1
2023/3/1 5:10,1,11,1,0,0,1,1
2023/3/1 5:20,1,11,1,0,2,1,3
2023/3/1 5:30,1,11,1,0,2,0,2
2023/3/1 5:40,1,11,1,0,1,1,2
2023/3/1 5:50,1,11,1,0,5,2,7
2023/3/1 6:00,1,12,1,0,4,2,6
2023/3/1 6:10,1,12,1,0,4,1,5
2023/3/1 6:20,1,12,1,0,4,2,6
2023/3/1 6:30,1,12,1,0,7,3,10
2023/3/1 6:40,1,12,1,0,13,2,15
2023/3/1 6:50,1,12,1,0,39,1,40
2023/3/1 7:00,1,12,1,0,58,3,61
2023/3/1 7:10,1,12,1,0,81,0,81
2023/3/1 7:20,1,12,1,0,100,3,103
2023/3/1 7:30,1,12,1,0,325,1,326
2023/3/1 7:40,1,12,1,0,548,5,553
2023/3/1 7:50,1,12,1,0,536,4,540
2023/3/1 8:00,1,12,1,0,308,8,316
2023/3/1 8:10,1,13,1,0,145,12,157
2023/3/1 8:20,1,13,1,0,82,8,90
2023/3/1 8:30,1,13,1,0,92,12,104
2023/3/1 8:40,1,13,1,0,83,16,99
2023/3/1 8:50,1,13,1,0,71,10,81
2023/3/1 9:00,1,13,1,0,76,15,91
2023/3/1 9:10,1,13,1,0,91,16,107
2023/3/1 9:20,1,13,1,0,146,27,173
2023/3/1 9:30,1,13,1,0,219,40,259
2023/3/1 9:40,1,14,1,0,238,113,351
2023/3/1 9:50,1,14,1,0,168,193,361
2023/3/1 10:00,1,14,1,0,149,138,287
2023/3/1 10:10,1,14,1,0,84,92,176
2023/3/1 10:20,1,14,1,0,87,65,152
2023/3/1 10:30,1,14,1,0,55,49,104
2023/3/1 10:40,1,14,1,0,65,47,112
2023/3/1 10:50,1,14,1,0,60,44,104
2023/3/1 11:00,1,14,1,0,71,34,105
2023/3/1 11:10,1,15,1,0,68,43,111
2023/3/1 11:20,1,15,1,0,54,48,102
2023/3/1 11:30,1,15,1,0,73,76,149
2023/3/1 11:40,1,15,1,0,78,240,318
2023/3/1 11:50,1,15,1,0,66,312,378
2023/3/1 12:00,1,15,1,0,58,278,336
2023/3/1 12:10,1,15,1,0,53,166,219
2023/3/1 12:20,1,16,1,0,54,124,178
2023/3/1 12:30,1,16,1,0,46,97,143
2023/3/1 12:40,1,16,1,0,29,61,90
2023/3/1 12:50,1,16,1,0,17,50,67
2023/3/1 13:00,1,17,1,0,14,27,41
2023/3/1 13:10,1,17,1,0,14,17,31
2023/3/1 13:20,1,17,1,0,14,16,30
2023/3/1 13:30,1,17,1,0,20,18,38
2023/3/1 13:40,1,17,1,0,27,20,47
2023/3/1 13:50,1,17,1,0,32,22,54
2023/3/1 14:00,1,17,1,0,28,23,51
2023/3/1 14:10,1,17,1,0,19,21,40
2023/3/1 14:20,1,17,1,0,16,20,36
2023/3/1 14:30,1,17,1,0,18,21,39
2023/3/1 14:40,1,18,1,0,20,14,34
2023/3/1 14:50,1,18,1,0,22,18,40
2023/3/1 15:00,1,18,1,0,25,14,39
2023/3/1 15:10,1,18,1,0,29,14,43
2023/3/1 15:20,1,18,1,0,24,14,38
2023/3/1 15:30,1,18,1,0,30,17,47
2023/3/1 15:40,1,18,1,0,27,23,50
2023/3/1 15:50,1,18,1,0,31,20,51
2023/3/1 16:00,1,18,1,0,28,15,43
2023/3/1 16:10,1,18,1,0,32,20,52
2023/3/1 16:20,1,18,1,0,30,16,46
2023/3/1 16:30,1,18,1,0,36,15,51
2023/3/1 16:40,1,18,1,0,30,13,43
2023/3/1 16:50,1,18,1,0,37,21,58
2023/3/1 17:00,1,18,1,0,47,24,71
2023/3/1 17:10,1,18,1,0,40,23,63
2023/3/1 17:20,1,18,1,0,50,27,77
2023/3/1 17:30,1,18,1,0,46,32,78
2023/3/1 17:40,1,17,1,0,45,32,77
2023/3/1 17:50,1,17,1,0,45,43,88
2023/3/1 18:00,1,17,1,0,60,44,104
2023/3/1 18:10,1,17,1,0,54,31,85
2023/3/1 18:20,1,17,1,0,47,27,74
2023/3/1 18:30,1,17,1,0,48,36,84
2023/3/1 18:40,1,17,1,0,52,26,78
2023/3/1 18:50,1,17,1,0,42,35,77
2023/3/1 19:00,1,17,1,0,40,25,65
2023/3/1 19:10,1,17,1,0,39,23,62
2023/3/1 19:20,1,16,1,0,31,25,56
2023/3/1 19:30,1,16,1,0,29,22,51
2023/3/1 19:40,1,16,1,0,34,20,54
2023/3/1 19:50,1,16,1,0,23,19,42
2023/3/1 20:00,1,16,1,0,31,29,60
2023/3/1 20:10,1,16,1,0,19,24,43
2023/3/1 20:20,1,16,1,0,17,30,47
2023/3/1 20:30,1,16,1,0,20,35,55
2023/3/1 20:40,1,16,1,0,20,41,61
2023/3/1 20:50,1,15,1,0,19,39,58
2023/3/1 21:00,1,15,1,0,15,41,56
2023/3/1 21:10,1,15,1,0,15,31,46
2023/3/1 21:20,1,15,1,0,12,28,40
2023/3/1 21:30,1,14,1,0,14,28,42
2023/3/1 21:40,1,14,1,0,7,46,53
2023/3/1 21:50,1,14,1,0,8,47,55
2023/3/1 22:00,1,14,1,0,7,38,45
2023/3/1 22:10,1,14,1,0,5,38,43
2023/3/1 22:20,1,14,1,0,2,31,33
2023/3/1 22:30,1,13,1,0,2,20,22
2023/3/1 22:40,1,13,1,0,2,14,16
2023/3/1 22:50,1,13,1,0,2,12,14
2023/3/1 23:00,1,13,1,0,1,5,6
2023/3/1 23:10,1,13,1,0,1,7,8
2023/3/1 23:20,1,13,1,0,2,3,5
2023/3/1 23:30,1,13,1,0,0,1,1
2023/3/1 23:40,1,13,1,0,1,2,3
2023/3/1 23:50,1,13,1,0,0,1,1
2023/3/2 0:00,1,13,1,0,3,1,4
2023/3/2 0:10,1,13,1,0,4,2,6
2023/3/2 0:20,1,12,1,0,2,2,4
2023/3/2 0:30,1,12,1,0,1,1,2
2023/3/2 0:40,1,12,1,0,2,2,4
2023/3/2 0:50,1,12,1,0,0,2,2
2023/3/2 1:00,1,12,1,0,1,0,1
2023/3/2 1:10,1,12,1,0,2,2,4
2023/3/2 1:20,1,12,1,0,0,0,0
2023/3/2 1:30,1,12,1,0,2,0,2
2023/3/2 1:40,1,12,1,0,1,2,3
2023/3/2 1:50,1,12,1,0,0,0,0
2023/3/2 2:00,1,12,1,0,2,1,3
2023/3/2 2:10,1,12,1,0,0,1,1
2023/3/2 2:20,1,12,1,0,0,1,1
2023/3/2 2:30,1,12,1,0,0,0,0
2023/3/2 2:40,1,11,1,0,0,0,0
2023/3/2 2:50,1,11,1,0,0,0,0
2023/3/2 3:00,1,11,1,0,2,2,4
2023/3/2 3:10,1,11,1,0,2,0,2
2023/3/2 3:20,1,11,1,0,2,2,4
2023/3/2 3:30,1,11,1,0,1,1,2
2023/3/2 3:40,1,11,1,0,2,1,3
2023/3/2 3:50,1,11,1,0,2,0,2
2023/3/2 4:00,1,11,1,0,1,2,3
2023/3/2 4:10,1,11,1,0,2,2,4
2023/3/2 4:20,1,11,1,0,2,0,2
2023/3/2 4:30,1,11,1,0,1,1,2
2023/3/2 4:40,1,11,1,0,2,1,3
2023/3/2 4:50,1,11,1,0,2,2,4
2023/3/2 5:00,1,12,1,0,1,2,3
2023/3/2 5:10,1,12,1,0,0,1,1
2023/3/2 5:20,1,12,1,0,2,1,3
2023/3/2 5:30,1,13,1,0,1,1,2
2023/3/2 5:40,1,13,1,0,0,1,1
2023/3/2 5:50,1,13,1,0,4,2,6
2023/3/2 6:00,1,13,1,0,4,3,7
2023/3/2 6:10,1,13,1,0,4,2,6
2023/3/2 6:20,1,13,1,0,5,1,6
2023/3/2 6:30,1,13,1,0,5,2,7
2023/3/2 6:40,1,14,1,0,13,0,13
2023/3/2 6:50,1,14,1,0,41,2,43
2023/3/2 7:00,1,14,1,0,60,3,63
2023/3/2 7:10,1,14,1,0,86,2,88
2023/3/2 7:20,1,14,1,0,115,2,117
2023/3/2 7:30,1,14,1,0,329,0,329
2023/3/2 7:40,1,15,1,0,582,5,587
2023/3/2 7:50,1,15,1,0,542,5,547
2023/3/2 8:00,1,15,1,0,315,7,322
2023/3/2 8:10,1,15,1,0,146,12,158
2023/3/2 8:20,1,15,1,0,84,8,92
2023/3/2 8:30,1,15,1,0,77,11,88
2023/3/2 8:40,1,15,1,0,81,13,94
2023/3/2 8:50,1,16,1,0,76,10,86
2023/3/2 9:00,1,16,1,0,82,14,96
2023/3/2 9:10,1,17,1,0,86,18,104
2023/3/2 9:20,1,17,1,0,164,26,190
2023/3/2 9:30,1,17,1,0,234,37,271
2023/3/2 9:40,1,17,1,0,259,126,385
2023/3/2 9:50,1,17,1,0,201,161,362
2023/3/2 10:00,1,17,1,0,127,158,285
2023/3/2 10:10,1,17,1,0,90,111,201
2023/3/2 10:20,1,18,1,0,83,66,149
2023/3/2 10:30,1,18,1,0,69,46,115
2023/3/2 10:40,1,18,1,0,64,48,112
2023/3/2 10:50,1,18,1,0,75,41,116
2023/3/2 11:00,1,18,1,0,67,38,105
2023/3/2 11:10,1,18,1,0,68,40,108
2023/3/2 11:20,1,18,1,0,61,47,108
2023/3/2 11:30,1,19,1,0,78,68,146
2023/3/2 11:40,1,19,1,0,65,200,265
2023/3/2 11:50,1,19,1,0,65,290,355
2023/3/2 12:00,1,19,1,0,57,241,298
2023/3/2 12:10,1,19,1,0,58,187,245
2023/3/2 12:20,1,19,1,0,65,123,188
2023/3/2 12:30,1,19,1,0,66,79,145
2023/3/2 12:40,1,19,1,0,55,59,114
2023/3/2 12:50,1,20,1,0,58,53,111
2023/3/2 13:00,1,20,1,0,62,28,90
2023/3/2 13:10,1,20,1,0,68,33,101
2023/3/2 13:20,1,20,1,0,97,30,127
2023/3/2 13:30,1,20,1,0,175,38,213
2023/3/2 13:40,1,21,1,0,222,33,255
2023/3/2 13:50,1,21,1,0,268,39,307
2023/3/2 14:00,1,21,1,0,126,27,153
2023/3/2 14:10,1,21,1,0,110,35,145
2023/3/2 14:20,1,21,1,0,104,34,138
2023/3/2 14:30,1,21,1,0,83,41,124
2023/3/2 14:40,1,21,1,0,71,47,118
2023/3/2 14:50,1,21,1,0,64,37,101
2023/3/2 15:00,1,21,1,0,67,51,118
2023/3/2 15:10,1,21,1,0,68,37,105
2023/3/2 15:20,1,21,1,0,76,45,121
2023/3/2 15:30,1,20,1,0,80,63,143
2023/3/2 15:40,1,20,1,0,124,168,292
2023/3/2 15:50,1,20,1,0,160,212,372
2023/3/2 16:00,1,20,1,0,102,144,246
2023/3/2 16:10,1,20,1,0,87,123,210
2023/3/2 16:20,1,20,1,0,71,76,147
2023/3/2 16:30,1,20,1,0,85,74,159
2023/3/2 16:40,1,20,1,0,65,59,124
2023/3/2 16:50,1,19,1,0,82,56,138
2023/3/2 17:00,1,19,1,0,74,50,124
2023/3/2 17:10,1,19,1,0,77,52,129
2023/3/2 17:20,1,19,1,0,74,48,122
2023/3/2 17:30,1,18,1,0,88,75,163
2023/3/2 17:40,1,18,1,0,85,260,345
2023/3/2 17:50,1,18,1,0,98,258,356
2023/3/2 18:00,1,17,1,0,81,221,302
2023/3/2 18:10,1,17,1,0,76,150,226
2023/3/2 18:20,1,17,1,0,91,89,180
2023/3/2 18:30,1,17,1,0,125,98,223
2023/3/2 18:40,1,17,1,0,189,77,266
2023/3/2 18:50,1,16,1,0,161,77,238
2023/3/2 19:00,1,16,1,0,146,63,209
2023/3/2 19:10,1,16,1,0,130,62,192
2023/3/2 19:20,1,16,1,0,95,56,151
2023/3/2 19:30,1,16,1,0,85,64,149
2023/3/2 19:40,1,15,1,0,95,61,156
2023/3/2 19:50,1,15,1,0,88,59,147
2023/3/2 20:00,1,15,1,0,76,75,151
2023/3/2 20:10,1,14,1,0,81,65,146
2023/3/2 20:20,1,14,1,0,86,64,150
2023/3/2 20:30,1,14,1,0,73,82,155
2023/3/2 20:40,1,14,1,0,62,205,267
2023/3/2 20:50,1,14,1,0,53,218,271
2023/3/2 21:00,1,14,1,0,44,152,196
2023/3/2 21:10,1,13,1,0,46,134,180
2023/3/2 21:20,1,13,1,0,33,117,150
2023/3/2 21:30,1,13,1,0,26,68,94
2023/3/2 21:40,1,13,1,0,16,75,91
2023/3/2 21:50,1,13,1,0,20,77,97
2023/3/2 22:00,1,12,1,0,15,85,100
2023/3/2 22:10,1,12,1,0,14,81,95
2023/3/2 22:20,1,12,1,0,15,45,60
2023/3/2 22:30,1,11,1,0,12,36,48
2023/3/2 22:40,1,11,1,0,13,22,35
2023/3/2 22:50,1,11,1,0,9,11,20
2023/3/2 23:00,1,11,1,0,8,11,19
2023/3/2 23:10,1,11,1,0,6,14,20
2023/3/2 23:20,1,11,1,0,4,8,12
2023/3/2 23:30,1,11,1,0,1,7,8
2023/3/2 23:40,1,10,1,0,2,8,10
2023/3/2 23:50,1,10,1,0,0,3,3
2023/3/3 0:00,1,10,1,0,4,1,5
2023/3/3 0:10,1,10,1,0,4,2,6
2023/3/3 0:20,1,10,1,0,4,1,5
2023/3/3 0:30,1,10,1,0,1,2,3
2023/3/3 0:40,1,10,1,0,3,1,4
2023/3/3 0:50,1,9,1,0,0,1,1
2023/3/3 1:00,1,9,1,0,1,0,1
2023/3/3 1:10,1,9,1,0,1,1,2
2023/3/3 1:20,1,9,1,0,1,2,3
2023/3/3 1:30,1,9,1,0,2,1,3
2023/3/3 1:40,1,9,1,0,0,0,0
2023/3/3 1:50,1,9,1,0,1,0,1
2023/3/3 2:00,1,8,1,0,0,1,1
2023/3/3 2:10,1,8,1,0,2,2,4
2023/3/3 2:20,1,8,1,0,2,0,2
2023/3/3 2:30,1,8,1,0,2,0,2
2023/3/3 2:40,1,8,1,0,1,2,3
2023/3/3 2:50,1,8,1,0,0,2,2
2023/3/3 3:00,1,8,1,0,1,1,2
2023/3/3 3:10,1,7,1,0,2,2,4
2023/3/3 3:20,1,7,1,0,1,2,3
2023/3/3 3:30,1,7,1,0,2,0,2
2023/3/3 3:40,1,7,1,0,2,2,4
2023/3/3 3:50,1,7,1,0,2,1,3
2023/3/3 4:00,1,7,1,0,2,1,3
2023/3/3 4:10,1,7,1,0,0,2,2
2023/3/3 4:20,1,7,1,0,2,1,3
2023/3/3 4:30,1,7,1,0,1,2,3
2023/3/3 4:40,1,7,1,0,0,2,2
2023/3/3 4:50,1,7,1,0,2,0,2
2023/3/3 5:00,1,7,1,0,0,1,1
2023/3/3 5:10,1,8,1,0,0,0,0
2023/3/3 5:20,1,8,1,0,2,1,3
2023/3/3 5:30,1,8,1,0,1,0,1
2023/3/3 5:40,1,8,1,0,1,0,1
2023/3/3 5:50,1,8,1,0,3,2,5
2023/3/3 6:00,1,8,1,0,3,4,7
2023/3/3 6:10,1,9,1,0,2,3,5
2023/3/3 6:20,1,9,1,0,5,1,6
2023/3/3 6:30,1,9,1,0,5,4,9
2023/3/3 6:40,1,9,1,0,10,0,10
2023/3/3 6:50,1,9,1,0,39,0,39
2023/3/3 7:00,1,9,1,0,56,3,59
2023/3/3 7:10,1,10,1,0,85,2,87
2023/3/3 7:20,1,10,1,0,120,3,123
2023/3/3 7:30,1,10,1,0,348,2,350
2023/3/3 7:40,1,10,1,0,542,3,545
2023/3/3 7:50,1,10,1,0,552,3,555
2023/3/3 8:00,1,10,1,0,313,6,319
2023/3/3 8:10,1,10,1,0,128,8,136
2023/3/3 8:20,1,10,1,0,84,9,93
2023/3/3 8:30,1,11,1,0,72,15,87
2023/3/3 8:40,1,11,1,0,71,16,87
2023/3/3 8:50,1,11,1,0,72,11,83
2023/3/3 9:00,1,11,1,0,86,17,103
2023/3/3 9:10,1,11,1,0,80,20,100
2023/3/3 9:20,1,11,1,0,137,25,162
2023/3/3 9:30,1,11,1,0,233,37,270
2023/3/3 9:40,1,11,1,0,283,145,428
2023/3/3 9:50,1,11,1,0,168,186,354
2023/3/3 10:00,1,12,1,0,125,156,281
2023/3/3 10:10,1,12,1,0,75,95,170
2023/3/3 10:20,1,12,1,0,79,64,143
2023/3/3 10:30,1,12,1,0,54,53,107
2023/3/3 10:40,1,12,1,0,71,47,118
2023/3/3 10:50,1,12,1,0,67,42,109
2023/3/3 11:00,1,12,1,0,65,38,103
2023/3/3 11:10,1,12,1,0,55,37,92
2023/3/3 11:20,1,12,1,0,63,44,107
2023/3/3 11:30,1,13,1,0,63,73,136
2023/3/3 11:40,1,13,1,0,65,202,267
2023/3/3 11:50,1,13,1,0,65,286,351
2023/3/3 12:00,1,13,1,0,64,237,301
2023/3/3 12:10,1,13,1,0,51,164,215
2023/3/3 12:20,1,13,1,0,64,128,192
2023/3/3 12:30,1,13,1,0,56,80,136
2023/3/3 12:40,1,13,1,0,65,71,136
2023/3/3 12:50,1,13,1,0,52,45,97
2023/3/3 13:00,1,13,1,0,54,34,88
2023/3/3 13:10,1,14,1,0,60,29,89
2023/3/3 13:20,1,14,1,0,84,30,114
2023/3/3 13:30,1,14,1,0,168,38,206
2023/3/3 13:40,1,14,1,0,232,39,271
2023/3/3 13:50,1,14,1,0,267,37,304
2023/3/3 14:00,1,14,1,0,119,35,154
2023/3/3 14:10,1,14,1,0,97,38,135
2023/3/3 14:20,1,14,1,0,108,34,142
2023/3/3 14:30,1,15,1,0,91,44,135
2023/3/3 14:40,1,15,1,0,74,48,122
2023/3/3 14:50,1,15,1,0,78,42,120
2023/3/3 15:00,1,15,1,0,73,47,120
2023/3/3 15:10,1,15,1,0,75,45,120
2023/3/3 15:20,1,15,1,0,87,37,124
2023/3/3 15:30,1,15,1,0,90,71,161
2023/3/3 15:40,1,15,1,0,150,174,324
2023/3/3 15:50,1,15,1,0,165,237,402
2023/3/3 16:00,1,15,1,0,101,159,260
2023/3/3 16:10,1,15,1,0,96,124,220
2023/3/3 16:20,1,15,1,0,77,72,149
2023/3/3 16:30,1,15,1,0,65,66,131
2023/3/3 16:40,1,14,1,0,69,55,124
2023/3/3 16:50,1,14,1,0,78,57,135
2023/3/3 17:00,1,14,1,0,74,63,137
2023/3/3 17:10,1,14,1,0,77,61,138
2023/3/3 17:20,1,14,1,0,88,56,144
2023/3/3 17:30,1,14,1,0,85,74,159
2023/3/3 17:40,1,14,1,0,98,242,340
2023/3/3 17:50,1,14,1,0,93,237,330
2023/3/3 18:00,1,14,1,0,92,233,325
2023/3/3 18:10,1,14,1,0,76,151,227
2023/3/3 18:20,1,14,1,0,90,86,176
2023/3/3 18:30,1,14,1,0,110,84,194
2023/3/3 18:40,1,13,1,0,164,71,235
2023/3/3 18:50,1,13,1,0,180,66,246
2023/3/3 19:00,1,13,1,0,117,66,183
2023/3/3 19:10,1,13,1,0,133,69,202
2023/3/3 19:20,1,13,1,0,111,68,179
2023/3/3 19:30,1,12,1,0,92,62,154
2023/3/3 19:40,1,12,1,0,85,66,151
2023/3/3 19:50,1,12,1,0,77,62,139
2023/3/3 20:00,1,12,1,0,74,64,138
2023/3/3 20:10,1,12,1,0,86,65,151
2023/3/3 20:20,1,12,1,0,77,57,134
2023/3/3 20:30,1,11,1,0,60,94,154
2023/3/3 20:40,1,11,1,0,62,215,277
2023/3/3 20:50,1,11,1,0,56,251,307
2023/3/3 21:00,1,11,1,0,43,150,193
2023/3/3 21:10,1,11,1,0,52,131,183
2023/3/3 21:20,1,11,1,0,30,122,152
2023/3/3 21:30,1,11,1,0,26,75,101
2023/3/3 21:40,1,11,1,0,19,81,100
2023/3/3 21:50,1,10,1,0,17,74,91
2023/3/3 22:00,1,10,1,0,17,73,90
2023/3/3 22:10,1,10,1,0,13,67,80
2023/3/3 22:20,1,10,1,0,14,47,61
2023/3/3 22:30,1,10,1,0,13,34,47
2023/3/3 22:40,1,10,1,0,12,22,34
2023/3/3 22:50,1,10,1,0,12,14,26
2023/3/3 23:00,1,10,1,0,10,10,20
2023/3/3 23:10,1,10,1,0,6,10,16
2023/3/3 23:20,1,10,1,0,4,8,12
2023/3/3 23:30,1,10,1,0,3,7,10
2023/3/3 23:40,1,9,1,0,3,8,11
2023/3/3 23:50,1,9,1,0,0,3,3
2023/3/4 0:00,1,9,0,0,3,3,6
2023/3/4 0:10,1,9,0,0,0,1,1
2023/3/4 0:20,1,9,0,0,0,1,1
2023/3/4 0:30,1,9,0,0,2,1,3
2023/3/4 0:40,1,9,0,0,1,1,2
2023/3/4 0:50,1,9,0,0,2,1,3
2023/3/4 1:00,1,9,0,0,1,0,1
2023/3/4 1:10,1,8,0,0,1,1,2
2023/3/4 1:20,1,8,0,0,0,1,1
2023/3/4 1:30,1,8,0,0,0,1,1
2023/3/4 1:40,1,8,0,0,2,1,3
2023/3/4 1:50,1,8,0,0,2,1,3
2023/3/4 2:00,1,8,0,0,2,2,4
2023/3/4 2:10,1,8,0,0,1,2,3
2023/3/4 2:20,1,8,0,0,0,1,1
2023/3/4 2:30,1,8,0,0,2,1,3
2023/3/4 2:40,1,8,0,0,1,2,3
2023/3/4 2:50,1,8,0,0,2,2,4
2023/3/4 3:00,1,8,0,0,1,2,3
2023/3/4 3:10,1,7,0,0,2,2,4
2023/3/4 3:20,1,7,0,0,2,1,3
2023/3/4 3:30,1,7,0,0,0,2,2
2023/3/4 3:40,1,7,0,0,1,2,3
2023/3/4 3:50,1,7,0,0,0,2,2
2023/3/4 4:00,1,7,0,0,2,0,2
2023/3/4 4:10,1,7,0,0,1,2,3
2023/3/4 4:20,1,7,0,0,2,1,3
2023/3/4 4:30,1,7,0,0,1,0,1
2023/3/4 4:40,1,7,0,0,1,2,3
2023/3/4 4:50,1,7,0,0,2,1,3
2023/3/4 5:00,1,7,0,0,0,2,2
2023/3/4 5:10,1,7,0,0,1,0,1
2023/3/4 5:20,1,7,0,0,2,1,3
2023/3/4 5:30,1,8,0,0,0,2,2
2023/3/4 5:40,1,8,0,0,1,1,2
2023/3/4 5:50,1,8,0,0,4,1,5
2023/3/4 6:00,1,8,0,0,7,0,7
2023/3/4 6:10,1,8,0,0,8,2,10
2023/3/4 6:20,1,8,0,0,7,0,7
2023/3/4 6:30,1,8,0,0,10,2,12
2023/3/4 6:40,1,8,0,0,13,1,14
2023/3/4 6:50,1,9,0,0,8,4,12
2023/3/4 7:00,1,9,0,0,17,0,17
2023/3/4 7:10,1,9,0,0,19,1,20
2023/3/4 7:20,1,10,0,0,38,1,39
2023/3/4 7:30,1,10,0,0,49,4,53
2023/3/4 7:40,1,10,0,0,64,3,67
2023/3/4 7:50,1,10,0,0,53,3,56
2023/3/4 8:00,1,10,0,0,41,6,47
2023/3/4 8:10,1,10,0,0,39,2,41
2023/3/4 8:20,1,11,0,0,33,0,33
2023/3/4 8:30,1,11,0,0,38,1,39
2023/3/4 8:40,1,11,0,0,32,5,37
2023/3/4 8:50,1,11,0,0,32,5,37
2023/3/4 9:00,1,11,0,0,33,2,35
2023/3/4 9:10,1,11,0,0,31,5,36
2023/3/4 9:20,1,11,0,0,33,7,40
2023/3/4 9:30,1,11,0,0,31,15,46
2023/3/4 9:40,1,11,0,0,40,14,54
2023/3/4 9:50,1,11,0,0,42,12,54
2023/3/4 10:00,1,12,0,0,37,15,52
2023/3/4 10:10,1,12,0,0,21,9,30
2023/3/4 10:20,1,12,0,0,23,8,31
2023/3/4 10:30,1,12,0,0,23,11,34
2023/3/4 10:40,1,12,0,0,19,13,32
2023/3/4 10:50,1,12,0,0,20,17,37
2023/3/4 11:00,1,12,0,0,17,18,35
2023/3/4 11:10,1,13,0,0,15,17,32
2023/3/4 11:20,1,13,0,0,14,22,36
2023/3/4 11:30,1,13,0,0,14,21,35
2023/3/4 11:40,1,13,0,0,10,23,33
2023/3/4 11:50,1,13,0,0,11,31,42
2023/3/4 12:00,1,14,0,0,11,35,46
2023/3/4 12:10,1,14,0,0,15,29,44
2023/3/4 12:20,1,14,0,0,13,32,45
2023/3/4 12:30,1,15,0,0,15,31,46
2023/3/4 12:40,1,15,0,0,12,29,41
2023/3/4 12:50,1,15,0,0,8,28,36
2023/3/4 13:00,1,15,0,0,8,22,30
2023/3/4 13:10,1,15,0,0,11,17,28
2023/3/4 13:20,1,15,0,0,13,14,27
2023/3/4 13:30,1,15,0,0,18,14,32
2023/3/4 13:40,1,15,0,0,29,19,48
2023/3/4 13:50,1,15,0,0,23,21,44
2023/3/4 14:00,1,16,0,0,25,21,46
2023/3/4 14:10,1,16,0,0,20,21,41
2023/3/4 14:20,1,16,0,0,16,15,31
2023/3/4 14:30,1,16,0,0,17,17,34
2023/3/4 14:40,1,16,0,0,16,15,31
2023/3/4 14:50,1,16,0,0,16,12,28
2023/3/4 15:00,1,16,0,0,22,9,31
2023/3/4 15:10,1,16,0,0,23,14,37
2023/3/4 15:20,1,16,0,0,23,13,36
2023/3/4 15:30,1,17,0,0,26,16,42
2023/3/4 15:40,1,17,0,0,23,18,41
2023/3/4 15:50,1,17,0,0,25,19,44
2023/3/4 16:00,1,17,0,0,24,17,41
2023/3/4 16:10,1,17,0,0,26,16,42
2023/3/4 16:20,1,17,0,0,26,11,37
2023/3/4 16:30,1,17,0,0,26,14,40
2023/3/4 16:40,1,17,0,0,30,11,41
2023/3/4 16:50,1,17,0,0,36,16,52
2023/3/4 17:00,1,17,0,0,37,16,53
2023/3/4 17:10,1,18,0,0,33,20,53
2023/3/4 17:20,1,18,0,0,34,20,54
2023/3/4 17:30,1,18,0,0,39,23,62
2023/3/4 17:40,1,18,0,0,30,34,64
2023/3/4 17:50,1,18,0,0,37,33,70
2023/3/4 18:00,1,19,0,0,48,29,77
2023/3/4 18:10,1,19,0,0,43,34,77
2023/3/4 18:20,1,19,0,0,44,24,68
2023/3/4 18:30,1,19,0,0,38,30,68
2023/3/4 18:40,1,19,0,0,38,28,66
2023/3/4 18:50,1,19,0,0,38,28,66
2023/3/4 19:00,1,19,0,0,33,21,54
2023/3/4 19:10,1,19,0,0,25,21,46
2023/3/4 19:20,1,19,0,0,22,22,44
2023/3/4 19:30,1,19,0,0,23,16,39
2023/3/4 19:40,1,19,0,0,24,21,45
2023/3/4 19:50,1,19,0,0,19,18,37
2023/3/4 20:00,1,19,0,0,20,21,41
2023/3/4 20:10,1,19,0,0,18,20,38
2023/3/4 20:20,1,19,0,0,17,22,39
2023/3/4 20:30,1,18,0,0,16,32,48
2023/3/4 20:40,1,18,0,0,15,28,43
2023/3/4 20:50,1,18,0,0,16,32,48
2023/3/4 21:00,1,18,0,0,14,37,51
2023/3/4 21:10,1,18,0,0,17,30,47
2023/3/4 21:20,1,18,0,0,12,21,33
2023/3/4 21:30,1,17,0,0,11,23,34
2023/3/4 21:40,1,17,0,0,6,40,46
2023/3/4 21:50,1,17,0,0,10,39,49
2023/3/4 22:00,1,17,0,0,7,35,42
2023/3/4 22:10,1,17,0,0,3,34,37
2023/3/4 22:20,1,16,0,0,3,26,29
2023/3/4 22:30,1,16,0,0,3,16,19
2023/3/4 22:40,1,16,0,0,2,13,15
2023/3/4 22:50,1,16,0,0,3,9,12
2023/3/4 23:00,1,16,0,0,2,7,9
2023/3/4 23:10,1,16,0,0,2,3,5
2023/3/4 23:20,1,16,0,0,0,1,1
2023/3/4 23:30,1,16,0,0,2,2,4
2023/3/4 23:40,1,15,0,0,0,3,3
2023/3/4 23:50,1,15,0,0,2,0,2
2023/3/5 0:00,1,15,0,0,1,1,2
2023/3/5 0:10,1,15,0,0,2,0,2
2023/3/5 0:20,1,15,0,0,2,1,3
2023/3/5 0:30,1,14,0,0,2,2,4
2023/3/5 0:40,1,14,0,0,0,1,1
2023/3/5 0:50,1,14,0,0,2,1,3
2023/3/5 1:00,1,14,0,0,0,2,2
2023/3/5 1:10,1,14,0,0,2,2,4
2023/3/5 1:20,1,14,0,0,1,1,2
2023/3/5 1:30,1,13,0,0,1,0,1
2023/3/5 1:40,1,13,0,0,1,2,3
2023/3/5 1:50,1,13,0,0,1,0,1
2023/3/5 2:00,1,13,0,0,1,1,2
2023/3/5 2:10,1,13,0,0,2,2,4
2023/3/5 2:20,1,13,0,0,2,0,2
2023/3/5 2:30,1,13,0,0,0,0,0
2023/3/5 2:40,1,12,0,0,2,2,4
2023/3/5 2:50,1,12,0,0,0,1,1
2023/3/5 3:00,1,12,0,0,2,2,4
2023/3/5 3:10,1,12,0,0,1,2,3
2023/3/5 3:20,1,11,0,0,1,2,3
2023/3/5 3:30,1,11,0,0,1,2,3
2023/3/5 3:40,1,11,0,0,2,1,3
2023/3/5 3:50,1,11,0,0,2,1,3
2023/3/5 4:00,1,11,0,0,0,1,1
2023/3/5 4:10,1,11,0,0,2,1,3
2023/3/5 4:20,1,11,0,0,1,0,1
2023/3/5 4:30,1,11,0,0,0,0,0
2023/3/5 4:40,1,11,0,0,0,1,1
2023/3/5 4:50,1,11,0,0,0,2,2
2023/3/5 5:00,1,11,0,0,2,1,3
2023/3/5 5:10,1,11,0,0,0,0,0
2023/3/5 5:20,1,11,0,0,3,0,3
2023/3/5 5:30,1,11,0,0,0,1,1
2023/3/5 5:40,1,12,0,0,1,1,2
2023/3/5 5:50,1,12,0,0,2,1,3
2023/3/5 6:00,1,12,0,0,7,2,9
2023/3/5 6:10,1,12,0,0,6,0,6
2023/3/5 6:20,1,12,0,0,7,1,8
2023/3/5 6:30,1,13,0,0,11,3,14
2023/3/5 6:40,1,13,0,0,13,0,13
2023/3/5 6:50,1,13,0,0,8,4,12
2023/3/5 7:00,1,13,0,0,16,2,18
2023/3/5 7:10,1,13,0,0,21,3,24
2023/3/5 7:20,1,14,0,0,41,3,44
2023/3/5 7:30,1,14,0,0,45,5,50
2023/3/5 7:40,1,14,0,0,55,2,57
2023/3/5 7:50,1,14,0,0,57,2,59
2023/3/5 8:00,1,14,0,0,43,5,48
2023/3/5 8:10,1,15,0,0,35,2,37
2023/3/5 8:20,1,15,0,0,35,2,37
2023/3/5 8:30,1,15,0,0,32,1,33
2023/3/5 8:40,1,15,0,0,30,5,35
2023/3/5 8:50,1,15,0,0,29,3,32
2023/3/5 9:00,1,15,0,0,33,2,35
2023/3/5 9:10,1,15,0,0,35,6,41
2023/3/5 9:20,1,15,0,0,37,7,44
2023/3/5 9:30,1,16,0,0,40,16,56
2023/3/5 9:40,1,16,0,0,38,17,55
2023/3/5 9:50,1,16,0,0,41,8,49
2023/3/5 10:00,1,17,0,0,37,18,55
2023/3/5 10:10,1,17,0,0,21,11,32
2023/3/5 10:20,1,17,0,0,20,9,29
2023/3/5 10:30,1,17,0,0,24,12,36
2023/3/5 10:40,1,17,0,0,20,14,34
2023/3/5 10:50,1,17,0,0,18,18,36
2023/3/5 11:00,1,17,0,0,13,19,32
2023/3/5 11:10,1,17,0,0,17,20,37
2023/3/5 11:20,1,18,0,0,10,19,29
2023/3/5 11:30,1,18,0,0,14,24,38
2023/3/5 11:40,1,18,0,0,9,25,34
2023/3/5 11:50,1,18,0,0,14,29,43
2023/3/5 12:00,1,19,0,0,12,33,45
2023/3/5 12:10,1,19,0,0,15,33,48
2023/3/5 12:20,1,19,0,0,13,25,38
2023/3/5 12:30,1,19,0,0,14,28,42
2023/3/5 12:40,1,19,0,0,12,35,47
2023/3/5 12:50,1,19,0,0,10,24,34
2023/3/5 13:00,1,20,0,0,8,21,29
2023/3/5 13:10,1,20,0,0,13,16,29
2023/3/5 13:20,1,20,0,0,16,18,34
2023/3/5 13:30,1,20,0,0,18,15,33
2023/3/5 13:40,1,20,0,0,28,16,44
2023/3/5 13:50,1,20,0,0,26,18,44
2023/3/5 14:00,1,20,0,0,20,16,36
2023/3/5 14:10,1,20,0,0,15,23,38
2023/3/5 14:20,1,20,0,0,17,14,31
2023/3/5 14:30,1,20,0,0,16,19,35
2023/3/5 14:40,1,20,0,0,18,15,33
2023/3/5 14:50,1,20,0,0,18,14,32
2023/3/5 15:00,1,21,0,0,23,12,35
2023/3/5 15:10,1,22,0,0,22,11,33
2023/3/5 15:20,1,22,0,0,22,13,35
2023/3/5 15:30,1,22,0,0,27,17,44
2023/3/5 15:40,1,22,0,0,25,18,43
2023/3/5 15:50,1,22,0,0,25,14,39
2023/3/5 16:00,1,23,0,0,22,15,37
2023/3/5 16:10,1,23,0,0,22,18,40
2023/3/5 16:20,1,23,0,0,27,13,40
2023/3/5 16:30,1,23,0,0,33,10,43
2023/3/5 16:40,1,24,0,0,31,13,44
2023/3/5 16:50,1,24,0,0,30,18,48
2023/3/5 17:00,1,24,0,0,36,16,52
2023/3/5 17:10,1,24,0,0,36,19,55
2023/3/5 17:20,1,24,0,0,36,23,59
2023/3/5 17:30,1,24,0,0,38,21,59
2023/3/5 17:40,1,24,0,0,35,30,65
2023/3/5 17:50,1,24,0,0,38,35,73
2023/3/5 18:00,1,24,0,0,48,37,85
2023/3/5 18:10,1,24,0,0,37,26,63
2023/3/5 18:20,1,24,0,0,43,29,72
2023/3/5 18:30,1,24,0,0,46,30,76
2023/3/5 18:40,1,24,0,0,40,27,67
2023/3/5 18:50,1,24,0,0,43,28,71
2023/3/5 19:00,1,24,0,0,31,20,51
2023/3/5 19:10,1,24,0,0,32,23,55
2023/3/5 19:20,1,23,0,0,27,17,44
2023/3/5 19:30,1,23,0,0,23,16,39
2023/3/5 19:40,1,23,0,0,27,21,48
2023/3/5 19:50,1,23,0,0,21,17,38
2023/3/5 20:00,1,22,0,0,22,23,45
2023/3/5 20:10,1,22,0,0,20,20,40
2023/3/5 20:20,1,21,0,0,15,26,41
2023/3/5 20:30,1,21,0,0,17,26,43
2023/3/5 20:40,1,21,0,0,18,26,44
2023/3/5 20:50,1,21,0,0,15,35,50
2023/3/5 21:00,1,20,0,0,13,33,46
2023/3/5 21:10,1,20,0,0,13,28,41
2023/3/5 21:20,1,20,0,0,11,27,38
2023/3/5 21:30,1,20,0,0,9,25,34
2023/3/5 21:40,1,19,0,0,6,35,41
2023/3/5 21:50,1,19,0,0,7,42,49
2023/3/5 22:00,1,19,0,0,5,35,40
2023/3/5 22:10,1,19,0,0,4,31,35
2023/3/5 22:20,1,18,0,0,4,28,32
2023/3/5 22:30,1,18,0,0,2,17,19
2023/3/5 22:40,1,18,0,0,1,14,15
2023/3/5 22:50,1,18,0,0,2,11,13
2023/3/5 23:00,1,18,0,0,2,5,7
2023/3/5 23:10,1,18,0,0,1,6,7
2023/3/5 23:20,1,17,0,0,0,2,2
2023/3/5 23:30,1,17,0,0,0,2,2
2023/3/5 23:40,1,17,0,0,2,1,3
2023/3/5 23:50,1,17,0,0,1,1,2
2023/3/6 0:00,1,17,1,0,4,0,4
2023/3/6 0:10,1,17,1,0,4,2,6
2023/3/6 0:20,1,17,1,0,2,1,3
2023/3/6 0:30,1,16,1,0,0,1,1
2023/3/6 0:40,1,16,1,0,3,0,3
2023/3/6 0:50,1,16,1,0,0,0,0
2023/3/6 1:00,1,16,1,0,2,2,4
2023/3/6 1:10,1,15,1,0,1,2,3
2023/3/6 1:20,1,15,1,0,0,0,0
2023/3/6 1:30,1,15,1,0,2,0,2
2023/3/6 1:40,1,15,1,0,2,2,4
2023/3/6 1:50,1,14,1,0,0,0,0
2023/3/6 2:00,1,14,1,0,1,0,1
2023/3/6 2:10,1,13,1,0,1,0,1
2023/3/6 2:20,1,13,1,0,1,0,1
2023/3/6 2:30,1,13,1,0,2,1,3
2023/3/6 2:40,1,13,1,0,1,2,3
2023/3/6 2:50,1,13,1,0,1,0,1
2023/3/6 3:00,1,13,1,0,2,0,2
2023/3/6 3:10,1,13,1,0,1,0,1
2023/3/6 3:20,1,12,1,0,1,0,1
2023/3/6 3:30,1,12,1,0,1,2,3
2023/3/6 3:40,1,12,1,0,0,2,2
2023/3/6 3:50,1,12,1,0,0,1,1
2023/3/6 4:00,1,12,1,0,2,0,2
2023/3/6 4:10,1,12,1,0,1,2,3
2023/3/6 4:20,1,12,1,0,2,1,3
2023/3/6 4:30,1,12,1,0,1,1,2
2023/3/6 4:40,1,12,1,0,2,1,3
2023/3/6 4:50,1,13,1,0,1,2,3
2023/3/6 5:00,1,13,1,0,1,1,2
2023/3/6 5:10,1,13,1,0,1,0,1
2023/3/6 5:20,1,13,1,0,1,0,1
2023/3/6 5:30,1,13,1,0,3,2,5
2023/3/6 5:40,1,13,1,0,0,2,2
2023/3/6 5:50,1,13,1,0,5,0,5
2023/3/6 6:00,1,14,1,0,4,4,8
2023/3/6 6:10,1,14,1,0,2,1,3
2023/3/6 6:20,1,14,1,0,5,1,6
2023/3/6 6:30,1,14,1,0,6,2,8
2023/3/6 6:40,1,14,1,0,13,1,14
2023/3/6 6:50,1,15,1,0,34,0,34
2023/3/6 7:00,1,15,1,0,65,2,67
2023/3/6 7:10,1,15,1,0,84,0,84
2023/3/6 7:20,1,16,1,0,120,2,122
2023/3/6 7:30,1,16,1,0,344,0,344
2023/3/6 7:40,1,16,1,0,517,3,520
2023/3/6 7:50,1,16,1,0,600,6,606
2023/3/6 8:00,1,16,1,0,328,8,336
2023/3/6 8:10,1,16,1,0,123,11,134
2023/3/6 8:20,1,17,1,0,82,10,92
2023/3/6 8:30,1,17,1,0,91,13,104
2023/3/6 8:40,1,17,1,0,73,12,85
2023/3/6 8:50,1,17,1,0,74,12,86
2023/3/6 9:00,1,17,1,0,89,14,103
2023/3/6 9:10,1,17,1,0,85,19,104
2023/3/6 9:20,1,18,1,0,160,32,192
2023/3/6 9:30,1,18,1,0,238,47,285
2023/3/6 9:40,1,18,1,0,270,143,413
2023/3/6 9:50,1,18,1,0,216,184,400
2023/3/6 10:00,1,18,1,0,148,143,291
2023/3/6 10:10,1,18,1,0,85,103,188
2023/3/6 10:20,1,19,1,0,78,64,142
2023/3/6 10:30,1,19,1,0,61,57,118
2023/3/6 10:40,1,19,1,0,61,45,106
2023/3/6 10:50,1,19,1,0,70,38,108
2023/3/6 11:00,1,19,1,0,67,36,103
2023/3/6 11:10,1,19,1,0,58,35,93
2023/3/6 11:20,1,20,1,0,63,44,107
2023/3/6 11:30,1,20,1,0,72,66,138
2023/3/6 11:40,1,20,1,0,75,250,325
2023/3/6 11:50,1,20,1,0,69,284,353
2023/3/6 12:00,1,20,1,0,60,230,290
2023/3/6 12:10,1,21,1,0,58,171,229
2023/3/6 12:20,1,21,1,0,57,135,192
2023/3/6 12:30,1,21,1,0,62,83,145
2023/3/6 12:40,1,21,1,0,54,74,128
2023/3/6 12:50,1,22,1,0,67,47,114
2023/3/6 13:00,1,22,1,0,65,29,94
2023/3/6 13:10,1,22,1,0,65,31,96
2023/3/6 13:20,1,22,1,0,94,35,129
2023/3/6 13:30,1,22,1,0,144,33,177
2023/3/6 13:40,1,22,1,0,229,34,263
2023/3/6 13:50,1,22,1,0,254,35,289
2023/3/6 14:00,1,22,1,0,144,29,173
2023/3/6 14:10,1,22,1,0,115,35,150
2023/3/6 14:20,1,22,1,0,87,37,124
2023/3/6 14:30,1,22,1,0,96,42,138
2023/3/6 14:40,1,22,1,0,80,44,124
2023/3/6 14:50,1,22,1,0,66,38,104
2023/3/6 15:00,1,22,1,0,69,40,109
2023/3/6 15:10,1,23,1,0,67,45,112
2023/3/6 15:20,1,23,1,0,74,40,114
2023/3/6 15:30,1,23,1,0,83,74,157
2023/3/6 15:40,1,24,1,0,128,158,286
2023/3/6 15:50,1,24,1,0,140,241,381
2023/3/6 16:00,1,24,1,0,100,145,245
2023/3/6 16:10,1,24,1,0,87,104,191
2023/3/6 16:20,1,24,1,0,66,71,137
2023/3/6 16:30,1,24,1,0,73,76,149
2023/3/6 16:40,1,24,1,0,74,61,135
2023/3/6 16:50,1,25,1,0,66,61,127
2023/3/6 17:00,1,25,1,0,83,53,136
2023/3/6 17:10,1,26,1,0,70,56,126
2023/3/6 17:20,1,26,1,0,85,57,142
2023/3/6 17:30,1,26,1,0,80,89,169
2023/3/6 17:40,1,26,1,0,93,242,335
2023/3/6 17:50,1,26,1,0,108,277,385
2023/3/6 18:00,1,26,1,0,88,217,305
2023/3/6 18:10,1,26,1,0,96,137,233
2023/3/6 18:20,1,26,1,0,84,99,183
2023/3/6 18:30,1,26,1,0,122,90,212
2023/3/6 18:40,1,25,1,0,164,65,229
2023/3/6 18:50,1,25,1,0,185,67,252
2023/3/6 19:00,1,25,1,0,123,69,192
2023/3/6 19:10,1,25,1,0,128,57,185
2023/3/6 19:20,1,25,1,0,102,61,163
2023/3/6 19:30,1,24,1,0,91,60,151
2023/3/6 19:40,1,24,1,0,99,56,155
2023/3/6 19:50,1,24,1,0,94,65,159
2023/3/6 20:00,1,24,1,0,90,75,165
2023/3/6 20:10,1,24,1,0,88,58,146
2023/3/6 20:20,1,24,1,0,87,59,146
2023/3/6 20:30,1,24,1,0,71,100,171
2023/3/6 20:40,1,23,1,0,69,207,276
2023/3/6 20:50,1,23,1,0,52,236,288
2023/3/6 21:00,1,23,1,0,55,172,227
2023/3/6 21:10,1,23,1,0,49,118,167
2023/3/6 21:20,1,23,1,0,29,103,132
2023/3/6 21:30,1,23,1,0,21,75,96
2023/3/6 21:40,1,23,1,0,19,82,101
2023/3/6 21:50,1,23,1,0,16,75,91
2023/3/6 22:00,1,23,1,0,17,84,101
2023/3/6 22:10,1,22,1,0,16,78,94
2023/3/6 22:20,1,22,1,0,14,53,67
2023/3/6 22:30,1,22,1,0,15,33,48
2023/3/6 22:40,1,22,1,0,11,19,30
2023/3/6 22:50,1,21,1,0,10,12,22
2023/3/6 23:00,1,21,1,0,9,11,20
2023/3/6 23:10,1,21,1,0,6,10,16
2023/3/6 23:20,1,21,1,0,4,8,12
2023/3/6 23:30,1,21,1,0,1,10,11
2023/3/6 23:40,1,20,1,0,1,8,9
2023/3/6 23:50,1,20,1,0,2,4,6
2023/3/7 0:00,1,20,1,0,5,1,6
2023/3/7 0:10,1,20,1,0,2,1,3
2023/3/7 0:20,1,19,1,0,3,1,4
2023/3/7 0:30,1,19,1,0,2,1,3
2023/3/7 0:40,1,19,1,0,3,1,4
2023/3/7 0:50,1,19,1,0,0,0,0
2023/3/7 1:00,1,19,1,0,2,1,3
2023/3/7 1:10,1,19,1,0,2,2,4
2023/3/7 1:20,1,18,1,0,0,0,0
2023/3/7 1:30,1,18,1,0,0,2,2
2023/3/7 1:40,1,18,1,0,0,2,2
2023/3/7 1:50,1,18,1,0,1,0,1
2023/3/7 2:00,1,17,1,0,2,2,4
2023/3/7 2:10,1,17,1,0,2,2,4
2023/3/7 2:20,1,17,1,0,2,2,4
2023/3/7 2:30,1,17,1,0,2,2,4
2023/3/7 2:40,1,17,1,0,2,2,4
2023/3/7 2:50,1,17,1,0,0,2,2
2023/3/7 3:00,1,16,1,0,2,2,4
2023/3/7 3:10,1,16,1,0,1,0,1
2023/3/7 3:20,1,16,1,0,1,2,3
2023/3/7 3:30,1,16,1,0,2,0,2
2023/3/7 3:40,1,16,1,0,0,1,1
2023/3/7 3:50,1,16,1,0,2,0,2
2023/3/7 4:00,1,16,1,0,1,0,1
2023/3/7 4:10,1,16,1,0,0,0,0
2023/3/7 4:20,1,16,1,0,0,2,2
2023/3/7 4:30,1,16,1,0,2,1,3
2023/3/7 4:40,1,16,1,0,0,1,1
2023/3/7 4:50,1,16,1,0,2,2,4
2023/3/7 5:00,1,16,1,0,1,1,2
2023/3/7 5:10,1,17,1,0,2,0,2
2023/3/7 5:20,1,17,1,0,0,1,1
2023/3/7 5:30,1,17,1,0,1,1,2
2023/3/7 5:40,1,17,1,0,1,0,1
2023/3/7 5:50,1,17,1,0,4,1,5
2023/3/7 6:00,1,17,1,0,3,2,5
2023/3/7 6:10,1,17,1,0,4,2,6
2023/3/7 6:20,1,18,1,0,6,3,9
2023/3/7 6:30,1,18,1,0,7,3,10
2023/3/7 6:40,1,18,1,0,14,1,15
2023/3/7 6:50,1,18,1,0,36,1,37
2023/3/7 7:00,1,18,1,0,63,4,67
2023/3/7 7:10,1,18,1,0,94,2,96
2023/3/7 7:20,1,18,1,0,99,3,102
2023/3/7 7:30,1,18,1,0,337,1,338
2023/3/7 7:40,1,19,1,0,518,3,521
2023/3/7 7:50,1,19,1,0,590,5,595
2023/3/7 8:00,1,19,1,0,312,6,318
2023/3/7 8:10,1,20,1,0,145,8,153
2023/3/7 8:20,1,20,1,0,105,8,113
2023/3/7 8:30,1,20,1,0,84,15,99
2023/3/7 8:40,1,20,1,0,80,15,95
2023/3/7 8:50,1,20,1,0,84,12,96
2023/3/7 9:00,1,20,1,0,89,17,106
2023/3/7 9:10,1,20,1,0,79,20,99
2023/3/7 9:20,1,20,1,0,164,29,193
2023/3/7 9:30,1,20,1,0,240,47,287
2023/3/7 9:40,1,21,1,0,240,121,361
2023/3/7 9:50,1,21,1,0,213,163,376
2023/3/7 10:00,1,21,1,0,125,159,284
2023/3/7 10:10,1,21,1,0,84,87,171
2023/3/7 10:20,1,21,1,0,77,75,152
2023/3/7 10:30,1,21,1,0,67,49,116
2023/3/7 10:40,1,21,1,0,67,44,111
2023/3/7 10:50,1,21,1,0,73,43,116
2023/3/7 11:00,1,21,1,0,66,43,109
2023/3/7 11:10,1,22,1,0,68,43,111
2023/3/7 11:20,1,22,1,0,60,41,101
2023/3/7 11:30,1,22,1,0,73,70,143
2023/3/7 11:40,1,22,1,0,68,245,313
2023/3/7 11:50,1,22,1,0,66,300,366
2023/3/7 12:00,1,22,1,0,58,286,344
2023/3/7 12:10,1,23,1,0,55,201,256
2023/3/7 12:20,1,23,1,0,64,116,180
2023/3/7 12:30,1,23,1,0,61,82,143
2023/3/7 12:40,1,23,1,0,53,66,119
2023/3/7 12:50,1,23,1,0,60,48,108
2023/3/7 13:00,1,23,1,0,55,33,88
2023/3/7 13:10,1,23,1,0,55,36,91
2023/3/7 13:20,1,24,1,0,85,32,117
2023/3/7 13:30,1,24,1,0,161,35,196
2023/3/7 13:40,1,24,1,0,248,33,281
2023/3/7 13:50,1,24,1,0,239,36,275
2023/3/7 14:00,1,24,1,0,111,28,139
2023/3/7 14:10,1,24,1,0,99,45,144
2023/3/7 14:20,1,24,1,0,108,36,144
2023/3/7 14:30,1,24,1,0,96,40,136
2023/3/7 14:40,1,24,1,0,72,42,114
2023/3/7 14:50,1,24,1,0,67,47,114
2023/3/7 15:00,1,24,1,0,80,40,120
2023/3/7 15:10,1,24,1,0,66,37,103
2023/3/7 15:20,1,24,1,0,78,46,124
2023/3/7 15:30,1,24,1,0,96,63,159
2023/3/7 15:40,1,24,1,0,151,167,318
2023/3/7 15:50,1,24,1,0,175,236,411
2023/3/7 16:00,1,23,1,0,96,157,253
2023/3/7 16:10,1,23,1,0,96,120,216
2023/3/7 16:20,1,23,1,0,78,72,150
2023/3/7 16:30,1,23,1,0,76,77,153
2023/3/7 16:40,1,22,1,0,69,52,121
2023/3/7 16:50,1,22,1,0,68,67,135
2023/3/7 17:00,1,22,1,0,81,57,138
2023/3/7 17:10,1,22,1,0,69,57,126
2023/3/7 17:20,1,22,1,0,86,48,134
2023/3/7 17:30,1,22,1,0,91,83,174
2023/3/7 17:40,1,22,1,0,96,227,323
2023/3/7 17:50,1,22,1,0,97,273,370
2023/3/7 18:00,1,21,1,0,93,190,283
2023/3/7 18:10,1,21,1,0,89,128,217
2023/3/7 18:20,1,21,1,0,103,100,203
2023/3/7 18:30,1,21,1,0,123,98,221
2023/3/7 18:40,1,21,1,0,177,76,253
2023/3/7 18:50,1,21,1,0,171,66,237
2023/3/7 19:00,1,20,1,0,125,56,181
2023/3/7 19:10,1,20,1,0,133,64,197
2023/3/7 19:20,1,20,1,0,96,68,164
2023/3/7 19:30,1,20,1,0,83,59,142
2023/3/7 19:40,1,20,1,0,79,59,138
2023/3/7 19:50,1,20,1,0,86,59,145
2023/3/7 20:00,1,20,1,0,73,64,137
2023/3/7 20:10,1,20,1,0,89,63,152
2023/3/7 20:20,1,20,1,0,72,71,143
2023/3/7 20:30,1,20,1,0,60,90,150
2023/3/7 20:40,1,20,1,0,68,215,283
2023/3/7 20:50,1,19,1,0,52,237,289
2023/3/7 21:00,1,19,1,0,45,148,193
2023/3/7 21:10,1,19,1,0,45,147,192
2023/3/7 21:20,1,19,1,0,30,116,146
2023/3/7 21:30,1,19,1,0,23,78,101
2023/3/7 21:40,1,19,1,0,19,73,92
2023/3/7 21:50,1,19,1,0,17,83,100
2023/3/7 22:00,1,19,1,0,14,78,92
2023/3/7 22:10,1,18,1,0,17,75,92
2023/3/7 22:20,1,18,1,0,15,46,61
2023/3/7 22:30,1,18,1,0,15,33,48
2023/3/7 22:40,1,18,1,0,11,19,30
2023/3/7 22:50,1,18,1,0,8,12,20
2023/3/7 23:00,1,18,1,0,10,13,23
2023/3/7 23:10,1,18,1,0,7,10,17
2023/3/7 23:20,1,17,1,0,4,8,12
2023/3/7 23:30,1,17,1,0,2,9,11
2023/3/7 23:40,1,17,1,0,2,10,12
2023/3/7 23:50,1,17,1,0,1,6,7
2023/3/8 0:00,1,16,1,0,4,2,6
2023/3/8 0:10,1,16,1,0,3,0,3
2023/3/8 0:20,1,15,1,0,4,2,6
2023/3/8 0:30,1,15,1,0,0,2,2
2023/3/8 0:40,1,15,1,0,3,1,4
2023/3/8 0:50,1,15,1,0,1,1,2
2023/3/8 1:00,1,15,1,0,0,1,1
2023/3/8 1:10,1,15,1,0,2,1,3
2023/3/8 1:20,1,15,1,0,1,1,2
2023/3/8 1:30,1,15,1,0,2,2,4
2023/3/8 1:40,1,15,1,0,2,2,4
2023/3/8 1:50,1,14,1,0,2,0,2
2023/3/8 2:00,1,14,1,0,1,2,3
2023/3/8 2:10,1,14,1,0,1,0,1
2023/3/8 2:20,1,14,1,0,0,2,2
2023/3/8 2:30,1,13,1,0,1,1,2
2023/3/8 2:40,1,13,1,0,2,1,3
2023/3/8 2:50,1,13,1,0,2,0,2
2023/3/8 3:00,1,13,1,0,2,0,2
2023/3/8 3:10,1,13,1,0,0,2,2
2023/3/8 3:20,1,13,1,0,2,1,3
2023/3/8 3:30,1,13,1,0,0,0,0
2023/3/8 3:40,1,13,1,0,1,2,3
2023/3/8 3:50,1,13,1,0,1,0,1
2023/3/8 4:00,1,13,1,0,0,2,2
2023/3/8 4:10,1,13,1,0,0,1,1
2023/3/8 4:20,1,13,1,0,1,0,1
2023/3/8 4:30,1,13,1,0,2,2,4
2023/3/8 4:40,1,13,1,0,1,2,3
2023/3/8 4:50,1,13,1,0,1,1,2
2023/3/8 5:00,1,13,1,0,0,2,2
2023/3/8 5:10,1,13,1,0,2,1,3
2023/3/8 5:20,1,13,1,0,1,0,1
2023/3/8 5:30,1,13,1,0,1,1,2
2023/3/8 5:40,1,13,1,0,2,1,3
2023/3/8 5:50,1,13,1,0,4,0,4
2023/3/8 6:00,1,13,1,0,3,3,6
2023/3/8 6:10,1,13,1,0,3,1,4
2023/3/8 6:20,1,14,1,0,4,1,5
2023/3/8 6:30,1,14,1,0,6,4,10
2023/3/8 6:40,1,14,1,0,13,0,13
2023/3/8 6:50,1,14,1,0,42,2,44
2023/3/8 7:00,1,14,1,0,64,3,67
2023/3/8 7:10,1,14,1,0,94,0,94
2023/3/8 7:20,1,14,1,0,124,2,126
2023/3/8 7:30,1,14,1,0,355,2,357
2023/3/8 7:40,1,14,1,0,488,4,492
2023/3/8 7:50,1,14,1,0,549,4,553
2023/3/8 8:00,1,14,1,0,262,7,269
2023/3/8 8:10,1,14,1,0,154,8,162
2023/3/8 8:20,1,14,1,0,93,8,101
2023/3/8 8:30,1,15,1,0,73,14,87
2023/3/8 8:40,1,15,1,0,79,16,95
2023/3/8 8:50,1,15,1,0,78,11,89
2023/3/8 9:00,1,15,1,0,86,17,103
2023/3/8 9:10,1,15,1,0,91,17,108
2023/3/8 9:20,1,15,1,0,134,28,162
2023/3/8 9:30,1,15,1,0,218,38,256
2023/3/8 9:40,1,15,1,0,255,130,385
2023/3/8 9:50,1,15,1,0,182,186,368
2023/3/8 10:00,1,15,1,0,127,143,270
2023/3/8 10:10,1,15,1,0,73,108,181
2023/3/8 10:20,1,16,1,0,76,72,148
2023/3/8 10:30,1,16,1,0,66,48,114
2023/3/8 10:40,1,16,1,0,70,52,122
2023/3/8 10:50,1,16,1,0,69,38,107
2023/3/8 11:00,1,16,1,0,70,41,111
2023/3/8 11:10,1,16,1,0,60,42,102
2023/3/8 11:20,1,16,1,0,55,45,100
2023/3/8 11:30,1,16,1,0,70,80,150
2023/3/8 11:40,1,16,1,0,69,209,278
2023/3/8 11:50,1,16,1,0,63,302,365
2023/3/8 12:00,1,16,1,0,64,288,352
2023/3/8 12:10,1,17,1,0,55,189,244
2023/3/8 12:20,1,17,1,0,56,136,192
2023/3/8 12:30,1,17,1,0,46,76,122
2023/3/8 12:40,1,17,1,0,31,61,92
2023/3/8 12:50,1,17,1,0,19,46,65
2023/3/8 13:00,1,17,1,0,19,28,47
2023/3/8 13:10,1,17,1,0,11,19,30
2023/3/8 13:20,1,17,1,0,17,16,33
2023/3/8 13:30,1,18,1,0,19,16,35
2023/3/8 13:40,1,18,1,0,34,21,55
2023/3/8 13:50,1,18,1,0,30,25,55
2023/3/8 14:00,1,18,1,0,27,20,47
2023/3/8 14:10,1,18,1,0,20,26,46
2023/3/8 14:20,1,18,1,0,16,16,32
2023/3/8 14:30,1,18,1,0,15,18,33
2023/3/8 14:40,1,18,1,0,19,16,35
2023/3/8 14:50,1,18,1,0,19,15,34
2023/3/8 15:00,1,18,1,0,21,12,33
2023/3/8 15:10,1,18,1,0,30,15,45
2023/3/8 15:20,1,18,1,0,26,18,44
2023/3/8 15:30,1,18,1,0,34,21,55
2023/3/8 15:40,1,18,1,0,32,23,55
2023/3/8 15:50,1,18,1,0,30,22,52
2023/3/8 16:00,1,18,1,0,31,16,47
2023/3/8 16:10,1,18,1,0,28,17,45
2023/3/8 16:20,1,18,1,0,26,14,40
2023/3/8 16:30,1,18,1,0,33,13,46
2023/3/8 16:40,1,18,1,0,35,15,50
2023/3/8 16:50,1,18,1,0,40,20,60
2023/3/8 17:00,1,18,1,0,44,24,68
2023/3/8 17:10,1,18,1,0,43,21,64
2023/3/8 17:20,1,18,1,0,42,27,69
2023/3/8 17:30,1,18,1,0,43,26,69
2023/3/8 17:40,1,18,1,0,44,34,78
2023/3/8 17:50,1,18,1,0,40,46,86
2023/3/8 18:00,1,18,1,0,49,39,88
2023/3/8 18:10,1,17,1,0,57,41,98
2023/3/8 18:20,1,17,1,0,54,32,86
2023/3/8 18:30,1,17,1,0,53,36,89
2023/3/8 18:40,1,17,1,0,47,28,75
2023/3/8 18:50,1,17,1,0,45,33,78
2023/3/8 19:00,1,17,1,0,38,29,67
2023/3/8 19:10,1,17,1,0,34,24,58
2023/3/8 19:20,1,17,1,0,33,25,58
2023/3/8 19:30,1,17,1,0,31,22,53
2023/3/8 19:40,1,16,1,0,32,26,58
2023/3/8 19:50,1,16,1,0,22,20,42
2023/3/8 20:00,1,16,1,0,28,25,53
2023/3/8 20:10,1,16,1,0,21,24,45
2023/3/8 20:20,1,16,1,0,19,28,47
2023/3/8 20:30,1,16,1,0,19,35,54
2023/3/8 20:40,1,16,1,0,18,41,59
2023/3/8 20:50,1,16,1,0,17,38,55
2023/3/8 21:00,1,16,1,0,16,45,61
2023/3/8 21:10,1,16,1,0,16,30,46
2023/3/8 21:20,1,16,1,0,13,28,41
2023/3/8 21:30,1,16,1,0,11,28,39
2023/3/8 21:40,1,16,1,0,7,44,51
2023/3/8 21:50,1,16,1,0,9,50,59
2023/3/8 22:00,1,15,1,0,5,46,51
2023/3/8 22:10,1,15,1,0,5,34,39
2023/3/8 22:20,1,15,1,0,3,32,35
2023/3/8 22:30,1,15,1,0,3,20,23
2023/3/8 22:40,1,15,1,0,2,13,15
2023/3/8 22:50,1,15,1,0,2,13,15
2023/3/8 23:00,1,14,1,0,1,5,6
2023/3/8 23:10,1,14,1,0,3,4,7
2023/3/8 23:20,1,14,1,0,2,1,3
2023/3/8 23:30,1,14,1,0,2,2,4
2023/3/8 23:40,1,14,1,0,2,2,4
2023/3/8 23:50,1,14,1,0,2,0,2
2023/3/9 0:00,1,14,1,0,4,2,6
2023/3/9 0:10,1,14,1,0,4,2,6
2023/3/9 0:20,1,14,1,0,3,1,4
2023/3/9 0:30,1,14,1,0,2,0,2
2023/3/9 0:40,1,14,1,0,2,1,3
2023/3/9 0:50,1,14,1,0,2,1,3
2023/3/9 1:00,1,14,1,0,0,2,2
2023/3/9 1:10,1,13,1,0,1,2,3
2023/3/9 1:20,1,13,1,0,1,2,3
2023/3/9 1:30,1,13,1,0,2,1,3
2023/3/9 1:40,1,13,1,0,2,2,4
2023/3/9 1:50,1,13,1,0,0,0,0
2023/3/9 2:00,1,13,1,0,0,0,0
2023/3/9 2:10,1,13,1,0,2,2,4
2023/3/9 2:20,1,13,1,0,2,0,2
2023/3/9 2:30,1,13,1,0,1,0,1
2023/3/9 2:40,1,13,1,0,2,1,3
2023/3/9 2:50,1,13,1,0,0,1,1
2023/3/9 3:00,1,13,1,0,1,1,2
2023/3/9 3:10,1,13,1,0,2,2,4
2023/3/9 3:20,1,13,1,0,1,2,3
2023/3/9 3:30,1,13,1,0,2,1,3
2023/3/9 3:40,1,13,1,0,1,0,1
2023/3/9 3:50,1,13,1,0,0,1,1
2023/3/9 4:00,1,13,1,0,1,1,2
2023/3/9 4:10,1,13,1,0,2,2,4
2023/3/9 4:20,1,13,1,0,0,0,0
2023/3/9 4:30,1,13,1,0,0,2,2
2023/3/9 4:40,1,13,1,0,0,0,0
2023/3/9 4:50,1,13,1,0,1,1,2
2023/3/9 5:00,1,13,1,0,0,2,2
2023/3/9 5:10,1,13,1,0,0,2,2
2023/3/9 5:20,1,14,1,0,2,0,2
2023/3/9 5:30,1,14,1,0,2,1,3
2023/3/9 5:40,1,14,1,0,2,1,3
2023/3/9 5:50,1,14,1,0,3,1,4
2023/3/9 6:00,1,14,1,0,4,3,7
2023/3/9 6:10,1,15,1,0,4,1,5
2023/3/9 6:20,1,15,1,0,6,3,9
2023/3/9 6:30,1,15,1,0,5,4,9
2023/3/9 6:40,1,15,1,0,14,0,14
2023/3/9 6:50,1,15,1,0,35,0,35
2023/3/9 7:00,1,15,1,0,60,4,64
2023/3/9 7:10,1,15,1,0,85,0,85
2023/3/9 7:20,1,15,1,0,111,2,113
2023/3/9 7:30,1,15,1,0,297,1,298
2023/3/9 7:40,1,15,1,0,516,4,520
2023/3/9 7:50,1,15,1,0,542,4,546
2023/3/9 8:00,1,16,1,0,287,8,295
2023/3/9 8:10,1,16,1,0,126,10,136
2023/3/9 8:20,1,16,1,0,85,8,93
2023/3/9 8:30,1,16,1,0,74,14,88
2023/3/9 8:40,1,17,1,0,69,16,85
2023/3/9 8:50,1,17,1,0,73,11,84
2023/3/9 9:00,1,17,1,0,72,14,86
2023/3/9 9:10,1,17,1,0,94,17,111
2023/3/9 9:20,1,17,1,0,149,28,177
2023/3/9 9:30,1,17,1,0,238,42,280
2023/3/9 9:40,1,18,1,0,260,115,375
2023/3/9 9:50,1,18,1,0,170,180,350
2023/3/9 10:00,1,18,1,0,152,162,314
2023/3/9 10:10,1,18,1,0,72,104,176
2023/3/9 10:20,1,18,1,0,67,77,144
2023/3/9 10:30,1,18,1,0,61,45,106
2023/3/9 10:40,1,18,1,0,61,49,110
2023/3/9 10:50,1,19,1,0,76,46,122
2023/3/9 11:00,1,19,1,0,72,43,115
2023/3/9 11:10,1,19,1,0,56,34,90
2023/3/9 11:20,1,19,1,0,62,47,109
2023/3/9 11:30,1,19,1,0,70,68,138
2023/3/9 11:40,1,19,1,0,74,203,277
2023/3/9 11:50,1,19,1,0,73,281,354
2023/3/9 12:00,1,19,1,0,65,261,326
2023/3/9 12:10,1,19,1,0,63,177,240
2023/3/9 12:20,1,20,1,0,57,131,188
2023/3/9 12:30,1,20,1,0,59,76,135
2023/3/9 12:40,1,20,1,0,58,68,126
2023/3/9 12:50,1,20,1,0,61,53,114
2023/3/9 13:00,1,21,1,0,66,34,100
2023/3/9 13:10,1,21,1,0,56,34,90
2023/3/9 13:20,1,21,1,0,88,30,118
2023/3/9 13:30,1,21,1,0,160,32,192
2023/3/9 13:40,1,21,1,0,267,35,302
2023/3/9 13:50,1,21,1,0,273,36,309
2023/3/9 14:00,1,21,1,0,113,35,148
2023/3/9 14:10,1,21,1,0,121,37,158
2023/3/9 14:20,1,22,1,0,112,41,153
2023/3/9 14:30,1,22,1,0,89,39,128
2023/3/9 14:40,1,22,1,0,71,40,111
2023/3/9 14:50,1,22,1,0,76,46,122
2023/3/9 15:00,1,22,1,0,65,40,105
2023/3/9 15:10,1,22,1,0,80,42,122
2023/3/9 15:20,1,22,1,0,80,45,125
2023/3/9 15:30,1,22,1,0,82,67,149
2023/3/9 15:40,1,23,1,0,137,154,291
2023/3/9 15:50,1,23,1,0,147,213,360
2023/3/9 16:00,1,23,1,0,116,139,255
2023/3/9 16:10,1,23,1,0,99,111,210
2023/3/9 16:20,1,23,1,0,79,89,168
2023/3/9 16:30,1,23,1,0,65,60,125
2023/3/9 16:40,1,23,1,0,63,52,115
2023/3/9 16:50,1,23,1,0,71,54,125
2023/3/9 17:00,1,23,1,0,78,57,135
2023/3/9 17:10,1,23,1,0,70,55,125
2023/3/9 17:20,1,23,1,0,86,56,142
2023/3/9 17:30,1,23,1,0,89,84,173
2023/3/9 17:40,1,23,1,0,78,244,322
2023/3/9 17:50,1,23,1,0,91,236,327
2023/3/9 18:00,1,23,1,0,86,226,312
2023/3/9 18:10,1,22,1,0,87,150,237
2023/3/9 18:20,1,22,1,0,98,91,189
2023/3/9 18:30,1,22,1,0,119,98,217
2023/3/9 18:40,1,22,1,0,194,66,260
2023/3/9 18:50,1,22,1,0,188,64,252
2023/3/9 19:00,1,22,1,0,138,59,197
2023/3/9 19:10,1,22,1,0,117,57,174
2023/3/9 19:20,1,22,1,0,106,67,173
2023/3/9 19:30,1,21,1,0,102,55,157
2023/3/9 19:40,1,21,1,0,81,60,141
2023/3/9 19:50,1,21,1,0,74,67,141
2023/3/9 20:00,1,21,1,0,73,75,148
2023/3/9 20:10,1,21,1,0,76,59,135
2023/3/9 20:20,1,21,1,0,74,57,131
2023/3/9 20:30,1,21,1,0,70,87,157
2023/3/9 20:40,1,21,1,0,62,188,250
2023/3/9 20:50,1,21,1,0,60,256,316
2023/3/9 21:00,1,21,1,0,49,161,210
2023/3/9 21:10,1,20,1,0,51,130,181
2023/3/9 21:20,1,20,1,0,34,94,128
2023/3/9 21:30,1,20,1,0,24,73,97
2023/3/9 21:40,1,20,1,0,18,79,97
2023/3/9 21:50,1,20,1,0,18,78,96
2023/3/9 22:00,1,20,1,0,16,80,96
2023/3/9 22:10,1,20,1,0,15,72,87
2023/3/9 22:20,1,19,1,0,17,53,70
2023/3/9 22:30,1,19,1,0,12,32,44
2023/3/9 22:40,1,19,1,0,12,19,31
2023/3/9 22:50,1,19,1,0,12,11,23
2023/3/9 23:00,1,19,1,0,10,14,24
2023/3/9 23:10,1,18,1,0,7,10,17
2023/3/9 23:20,1,18,1,0,4,10,14
2023/3/9 23:30,1,18,1,0,2,9,11
2023/3/9 23:40,1,18,1,0,3,10,13
2023/3/9 23:50,1,18,1,0,2,6,8
2023/3/10 0:00,1,18,1,0,4,0,4
2023/3/10 0:10,1,18,1,0,2,1,3
2023/3/10 0:20,1,18,1,0,3,3,6
2023/3/10 0:30,1,18,1,0,0,2,2
2023/3/10 0:40,1,17,1,0,3,1,4
2023/3/10 0:50,1,17,1,0,0,0,0
2023/3/10 1:00,1,17,1,0,2,2,4
2023/3/10 1:10,1,17,1,0,2,0,2
2023/3/10 1:20,1,17,1,0,0,0,0
2023/3/10 1:30,1,17,1,0,0,0,0
2023/3/10 1:40,1,17,1,0,2,2,4
2023/3/10 1:50,1,17,1,0,1,0,1
2023/3/10 2:00,1,17,1,0,2,1,3
2023/3/10 2:10,1,16,1,0,2,1,3
2023/3/10 2:20,1,16,1,0,2,2,4
2023/3/10 2:30,1,16,1,0,2,2,4
2023/3/10 2:40,1,16,1,0,2,0,2
2023/3/10 2:50,1,16,1,0,2,0,2
2023/3/10 3:00,1,15,1,0,2,1,3
2023/3/10 3:10,1,15,1,0,2,1,3
2023/3/10 3:20,1,15,1,0,2,2,4
2023/3/10 3:30,1,15,1,0,1,0,1
2023/3/10 3:40,1,15,1,0,2,1,3
2023/3/10 3:50,1,15,1,0,2,1,3
2023/3/10 4:00,1,15,1,0,0,2,2
2023/3/10 4:10,1,15,1,0,0,1,1
2023/3/10 4:20,1,15,1,0,0,2,2
2023/3/10 4:30,1,15,1,0,2,2,4
2023/3/10 4:40,1,15,1,0,2,1,3
2023/3/10 4:50,1,15,1,0,2,2,4
2023/3/10 5:00,1,16,1,0,2,1,3
2023/3/10 5:10,1,16,1,0,0,2,2
2023/3/10 5:20,1,16,1,0,0,1,1
2023/3/10 5:30,1,16,1,0,3,1,4
2023/3/10 5:40,1,16,1,0,0,2,2
2023/3/10 5:50,1,16,1,0,4,1,5
2023/3/10 6:00,1,16,1,0,2,2,4
2023/3/10 6:10,1,17,1,0,2,2,4
2023/3/10 6:20,1,17,1,0,7,3,10
2023/3/10 6:30,1,17,1,0,7,2,9
2023/3/10 6:40,1,17,1,0,10,1,11
2023/3/10 6:50,1,17,1,0,40,1,41
2023/3/10 7:00,1,17,1,0,53,3,56
2023/3/10 7:10,1,17,1,0,90,2,92
2023/3/10 7:20,1,17,1,0,102,1,103
2023/3/10 7:30,1,18,1,0,300,1,301
2023/3/10 7:40,1,18,1,0,617,5,622
2023/3/10 7:50,1,18,1,0,554,3,557
2023/3/10 8:00,1,18,1,0,300,6,306
2023/3/10 8:10,1,19,1,0,128,9,137
2023/3/10 8:20,1,19,1,0,101,9,110
2023/3/10 8:30,1,19,1,0,91,15,106
2023/3/10 8:40,1,19,1,0,78,15,93
2023/3/10 8:50,1,19,1,0,79,12,91
2023/3/10 9:00,1,19,1,0,86,15,101
2023/3/10 9:10,1,20,1,0,86,16,102
2023/3/10 9:20,0,20,1,0,32,6,38
2023/3/10 9:30,0,21,1,0,40,9,49
2023/3/10 9:40,0,21,1,0,50,29,79
2023/3/10 9:50,0,21,1,0,38,39,77
2023/3/10 10:00,0,21,1,0,26,31,57
2023/3/10 10:10,0,21,1,0,15,19,34
2023/3/10 10:20,0,22,1,0,13,14,27
2023/3/10 10:30,0,22,1,0,14,10,24
2023/3/10 10:40,0,22,1,0,13,10,23
2023/3/10 10:50,0,22,1,0,14,8,22
2023/3/10 11:00,0,22,1,0,14,7,21
2023/3/10 11:10,0,23,1,0,13,8,21
2023/3/10 11:20,0,24,1,0,13,8,21
2023/3/10 11:30,0,24,1,0,14,15,29
2023/3/10 11:40,0,24,1,0,14,42,56
2023/3/10 11:50,0,24,1,0,12,56,68
2023/3/10 12:00,0,25,1,0,11,47,58
2023/3/10 12:10,0,25,1,0,12,35,47
2023/3/10 12:20,0,25,1,0,12,23,35
2023/3/10 12:30,0,25,1,0,14,18,32
2023/3/10 12:40,0,25,1,0,11,13,24
2023/3/10 12:50,0,25,1,0,11,10,21
2023/3/10 13:00,0,26,1,0,13,6,19
2023/3/10 13:10,0,26,1,0,11,7,18
2023/3/10 13:20,0,26,1,0,16,7,23
2023/3/10 13:30,0,26,1,0,37,7,44
2023/3/10 13:40,0,26,1,0,44,8,52
2023/3/10 13:50,0,27,1,0,44,7,51
2023/3/10 14:00,0,27,1,0,24,6,30
2023/3/10 14:10,0,27,1,0,21,9,30
2023/3/10 14:20,0,27,1,0,20,7,27
2023/3/10 14:30,0,27,1,0,17,7,24
2023/3/10 14:40,0,27,1,0,16,8,24
2023/3/10 14:50,0,27,1,0,16,9,25
2023/3/10 15:00,0,27,1,0,15,8,23
2023/3/10 15:10,0,27,1,0,16,7,23
2023/3/10 15:20,0,27,1,0,17,9,26
2023/3/10 15:30,0,27,1,0,16,12,28
2023/3/10 15:40,0,27,1,0,30,38,68
2023/3/10 15:50,0,27,1,0,35,47,82
2023/3/10 16:00,0,27,1,0,23,29,52
2023/3/10 16:10,0,27,1,0,17,25,42
2023/3/10 16:20,0,27,1,0,17,15,32
2023/3/10 16:30,0,27,1,0,15,14,29
2023/3/10 16:40,0,27,1,0,15,13,28
2023/3/10 16:50,0,26,1,0,16,13,29
2023/3/10 17:00,0,25,1,0,15,13,28
2023/3/10 17:10,0,25,1,0,15,11,26
2023/3/10 17:20,0,24,1,0,16,12,28
2023/3/10 17:30,0,24,1,0,17,18,35
2023/3/10 17:40,0,24,1,0,17,47,64
2023/3/10 17:50,0,23,1,0,19,52,71
2023/3/10 18:00,0,23,1,0,18,40,58
2023/3/10 18:10,0,23,1,0,18,27,45
2023/3/10 18:20,0,23,1,0,21,17,38
2023/3/10 18:30,0,23,1,0,22,18,40
2023/3/10 18:40,0,23,1,0,31,15,46
2023/3/10 18:50,0,22,1,0,32,12,44
2023/3/10 19:00,0,22,1,0,24,12,36
2023/3/10 19:10,0,22,1,0,25,13,38
2023/3/10 19:20,0,22,1,0,21,12,33
2023/3/10 19:30,0,21,1,0,18,11,29
2023/3/10 19:40,0,21,1,0,20,10,30
2023/3/10 19:50,0,21,1,0,16,11,27
2023/3/10 20:00,0,20,1,0,15,14,29
2023/3/10 20:10,0,20,1,0,15,14,29
2023/3/10 20:20,0,20,1,0,16,11,27
2023/3/10 20:30,0,20,1,0,13,20,33
2023/3/10 20:40,0,20,1,0,12,39,51
2023/3/10 20:50,0,20,1,0,12,49,61
2023/3/10 21:00,0,20,1,0,9,29,38
2023/3/10 21:10,0,19,1,0,9,28,37
2023/3/10 21:20,0,19,1,0,6,23,29
2023/3/10 21:30,0,19,1,0,4,12,16
2023/3/10 21:40,0,19,1,0,4,13,17
2023/3/10 21:50,0,19,1,0,4,17,21
2023/3/10 22:00,0,19,1,0,3,18,21
2023/3/10 22:10,0,19,1,0,3,17,20
2023/3/10 22:20,0,19,1,0,3,9,12
2023/3/10 22:30,0,19,1,0,3,6,9
2023/3/10 22:40,1,19,1,0,9,13,22
2023/3/10 22:50,1,18,1,0,5,12,17
2023/3/10 23:00,1,18,1,0,6,14,20
2023/3/10 23:10,1,18,1,0,7,12,19
2023/3/10 23:20,1,18,1,0,6,8,14
2023/3/10 23:30,1,18,1,0,3,9,12
2023/3/10 23:40,1,18,1,0,2,9,11
2023/3/10 23:50,1,18,1,0,1,5,6
2023/3/11 0:00,1,17,0,0,3,2,5
2023/3/11 0:10,1,17,0,0,2,2,4
2023/3/11 0:20,1,17,0,0,1,0,1
2023/3/11 0:30,1,17,0,0,2,2,4
2023/3/11 0:40,1,17,0,0,2,2,4
2023/3/11 0:50,1,16,0,0,1,0,1
2023/3/11 1:00,1,16,0,0,0,0,0
2023/3/11 1:10,1,16,0,0,0,1,1
2023/3/11 1:20,1,16,0,0,1,0,1
2023/3/11 1:30,1,16,0,0,0,0,0
2023/3/11 1:40,1,15,0,0,0,0,0
2023/3/11 1:50,1,15,0,0,2,0,2
2023/3/11 2:00,1,15,0,0,0,1,1
2023/3/11 2:10,1,15,0,0,2,0,2
2023/3/11 2:20,1,15,0,0,2,1,3
2023/3/11 2:30,1,15,0,0,0,1,1
2023/3/11 2:40,1,14,0,0,0,2,2
2023/3/11 2:50,1,14,0,0,0,1,1
2023/3/11 3:00,1,14,0,0,1,0,1
2023/3/11 3:10,1,14,0,0,0,0,0
2023/3/11 3:20,1,14,0,0,0,0,0
2023/3/11 3:30,1,14,0,0,1,2,3
2023/3/11 3:40,1,14,0,0,1,1,2
2023/3/11 3:50,1,14,0,0,0,0,0
2023/3/11 4:00,1,14,0,0,2,0,2
2023/3/11 4:10,1,15,0,0,2,2,4
2023/3/11 4:20,1,15,0,0,0,1,1
2023/3/11 4:30,1,15,0,0,1,2,3
2023/3/11 4:40,1,15,0,0,2,1,3
2023/3/11 4:50,1,15,0,0,1,2,3
2023/3/11 5:00,1,15,0,0,1,2,3
2023/3/11 5:10,1,15,0,0,2,0,2
2023/3/11 5:20,1,15,0,0,2,0,2
2023/3/11 5:30,1,15,0,0,2,1,3
2023/3/11 5:40,1,15,0,0,2,2,4
2023/3/11 5:50,1,15,0,0,3,0,3
2023/3/11 6:00,1,16,0,0,5,0,5
2023/3/11 6:10,1,16,0,0,7,2,9
2023/3/11 6:20,1,16,0,0,6,0,6
2023/3/11 6:30,1,16,0,0,8,4,12
2023/3/11 6:40,1,17,0,0,11,2,13
2023/3/11 6:50,1,17,0,0,8,3,11
2023/3/11 7:00,1,17,0,0,16,2,18
2023/3/11 7:10,1,17,0,0,21,1,22
2023/3/11 7:20,1,17,0,0,40,1,41
2023/3/11 7:30,1,17,0,0,56,3,59
2023/3/11 7:40,1,17,0,0,64,3,67
2023/3/11 7:50,1,17,0,0,61,1,62
2023/3/11 8:00,1,18,0,0,44,3,47
2023/3/11 8:10,1,18,0,0,37,4,41
2023/3/11 8:20,1,18,0,0,30,0,30
2023/3/11 8:30,1,18,0,0,33,3,36
2023/3/11 8:40,1,18,0,0,28,4,32
2023/3/11 8:50,1,18,0,0,30,5,35
2023/3/11 9:00,1,18,0,0,35,3,38
2023/3/11 9:10,1,19,0,0,31,5,36
2023/3/11 9:20,1,19,0,0,32,6,38
2023/3/11 9:30,1,19,0,0,35,12,47
2023/3/11 9:40,1,19,0,0,38,14,52
2023/3/11 9:50,1,19,0,0,34,12,46
2023/3/11 10:00,1,19,0,0,38,15,53
2023/3/11 10:10,1,20,0,0,23,9,32
2023/3/11 10:20,1,20,0,0,19,9,28
2023/3/11 10:30,1,20,0,0,24,12,36
2023/3/11 10:40,1,20,0,0,20,15,35
2023/3/11 10:50,1,20,0,0,20,17,37
2023/3/11 11:00,1,21,0,0,16,16,32
2023/3/11 11:10,1,21,0,0,16,16,32
2023/3/11 11:20,1,21,0,0,13,17,30
2023/3/11 11:30,1,21,0,0,16,19,35
2023/3/11 11:40,1,21,0,0,12,24,36
2023/3/11 11:50,1,21,0,0,14,30,44
2023/3/11 12:00,1,21,0,0,9,29,38
2023/3/11 12:10,1,21,0,0,12,27,39
2023/3/11 12:20,1,22,0,0,11,30,41
2023/3/11 12:30,1,22,0,0,14,30,44
2023/3/11 12:40,1,22,0,0,13,33,46
2023/3/11 12:50,1,22,0,0,9,30,39
2023/3/11 13:00,1,22,0,0,9,23,32
2023/3/11 13:10,1,22,0,0,10,19,29
2023/3/11 13:20,1,22,0,0,14,18,32
2023/3/11 13:30,1,22,0,0,14,16,30
2023/3/11 13:40,1,22,0,0,26,18,44
2023/3/11 13:50,1,22,0,0,26,18,44
2023/3/11 14:00,1,22,0,0,24,21,45
2023/3/11 14:10,1,22,0,0,15,20,35
2023/3/11 14:20,1,21,0,0,16,17,33
2023/3/11 14:30,1,21,0,0,17,17,34
2023/3/11 14:40,1,21,0,0,15,14,29
2023/3/11 14:50,1,21,0,0,19,15,34
2023/3/11 15:00,1,21,0,0,21,9,30
2023/3/11 15:10,1,21,0,0,22,13,35
2023/3/11 15:20,1,21,0,0,20,16,36
2023/3/11 15:30,1,20,0,0,28,14,42
2023/3/11 15:40,1,20,0,0,20,21,41
2023/3/11 15:50,1,20,0,0,27,15,42
2023/3/11 16:00,1,20,0,0,26,15,41
2023/3/11 16:10,1,20,0,0,25,14,39
2023/3/11 16:20,1,20,0,0,27,14,41
2023/3/11 16:30,1,20,0,0,30,13,43
2023/3/11 16:40,1,20,0,0,28,11,39
2023/3/11 16:50,1,20,0,0,30,15,45
2023/3/11 17:00,1,20,0,0,34,15,49
2023/3/11 17:10,1,19,0,0,35,22,57
2023/3/11 17:20,1,19,0,0,35,24,59
2023/3/11 17:30,1,19,0,0,41,26,67
2023/3/11 17:40,1,19,0,0,30,34,64
2023/3/11 17:50,1,18,0,0,33,32,65
2023/3/11 18:00,1,18,0,0,48,29,77
2023/3/11 18:10,1,18,0,0,37,30,67
2023/3/11 18:20,1,18,0,0,41,30,71
2023/3/11 18:30,1,18,0,0,46,26,72
2023/3/11 18:40,1,18,0,0,38,27,65
2023/3/11 18:50,1,18,0,0,38,30,68
2023/3/11 19:00,1,17,0,0,34,21,55
2023/3/11 19:10,1,17,0,0,25,20,45
2023/3/11 19:20,1,17,0,0,24,18,42
2023/3/11 19:30,1,17,0,0,26,20,46
2023/3/11 19:40,1,17,0,0,25,21,46
2023/3/11 19:50,1,17,0,0,23,17,40
2023/3/11 20:00,1,17,0,0,24,19,43
2023/3/11 20:10,1,16,0,0,19,21,40
2023/3/11 20:20,1,16,0,0,15,21,36
2023/3/11 20:30,1,16,0,0,19,25,44
2023/3/11 20:40,1,16,0,0,16,34,50
2023/3/11 20:50,1,16,0,0,17,33,50
2023/3/11 21:00,1,16,0,0,11,37,48
2023/3/11 21:10,1,16,0,0,13,29,42
2023/3/11 21:20,1,15,0,0,10,27,37
2023/3/11 21:30,1,15,0,0,8,25,33
2023/3/11 21:40,1,15,0,0,9,41,50
2023/3/11 21:50,1,15,0,0,7,39,46
2023/3/11 22:00,1,15,0,0,7,39,46
2023/3/11 22:10,1,15,0,0,5,29,34
2023/3/11 22:20,1,15,0,0,2,29,31
2023/3/11 22:30,1,14,0,0,2,18,20
2023/3/11 22:40,1,14,0,0,2,13,15
2023/3/11 22:50,1,14,0,0,4,9,13
2023/3/11 23:00,1,14,0,0,3,4,7
2023/3/11 23:10,1,14,0,0,3,4,7
2023/3/11 23:20,1,14,0,0,1,1,2
2023/3/11 23:30,1,14,0,0,0,2,2
2023/3/11 23:40,1,13,0,0,2,3,5
2023/3/11 23:50,1,13,0,0,2,1,3
2023/3/12 0:00,1,13,0,0,2,1,3
2023/3/12 0:10,1,13,0,0,1,1,2
2023/3/12 0:20,1,13,0,0,0,1,1
2023/3/12 0:30,1,13,0,0,1,0,1
2023/3/12 0:40,1,12,0,0,2,1,3
2023/3/12 0:50,1,12,0,0,1,1,2
2023/3/12 1:00,1,11,0,0,0,2,2
2023/3/12 1:10,1,11,0,0,0,0,0
2023/3/12 1:20,1,11,0,0,0,0,0
2023/3/12 1:30,1,11,0,0,1,2,3
2023/3/12 1:40,1,11,0,0,2,1,3
2023/3/12 1:50,1,11,0,0,2,2,4
2023/3/12 2:00,1,11,0,0,0,0,0
2023/3/12 2:10,1,11,0,0,2,2,4
2023/3/12 2:20,1,11,0,0,2,0,2
2023/3/12 2:30,1,10,0,0,2,1,3
2023/3/12 2:40,1,10,0,0,1,1,2
2023/3/12 2:50,1,10,0,0,2,1,3
2023/3/12 3:00,1,10,0,0,1,2,3
2023/3/12 3:10,1,10,0,0,0,0,0
2023/3/12 3:20,1,10,0,0,0,0,0
2023/3/12 3:30,1,10,0,0,0,1,1
2023/3/12 3:40,1,10,0,0,1,1,2
2023/3/12 3:50,1,10,0,0,1,0,1
2023/3/12 4:00,1,10,0,0,1,0,1
2023/3/12 4:10,1,10,0,0,0,0,0
2023/3/12 4:20,1,10,0,0,2,0,2
2023/3/12 4:30,1,10,0,0,2,1,3
2023/3/12 4:40,1,10,0,0,0,0,0
2023/3/12 4:50,1,11,0,0,0,2,2
2023/3/12 5:00,1,11,0,0,0,2,2
2023/3/12 5:10,1,11,0,0,2,2,4
2023/3/12 5:20,1,11,0,0,2,2,4
2023/3/12 5:30,1,11,0,0,1,1,2
2023/3/12 5:40,1,11,0,0,1,2,3
2023/3/12 5:50,1,12,0,0,2,0,2
2023/3/12 6:00,1,12,0,0,4,0,4
2023/3/12 6:10,1,12,0,0,7,2,9
2023/3/12 6:20,1,12,0,0,6,2,8
2023/3/12 6:30,1,12,0,0,8,3,11
2023/3/12 6:40,1,12,0,0,13,2,15
2023/3/12 6:50,1,12,0,0,9,3,12
2023/3/12 7:00,1,12,0,0,13,1,14
2023/3/12 7:10,1,13,0,0,22,2,24
2023/3/12 7:20,1,13,0,0,40,2,42
2023/3/12 7:30,1,13,0,0,46,5,51
2023/3/12 7:40,1,13,0,0,62,4,66
2023/3/12 7:50,1,13,0,0,50,3,53
2023/3/12 8:00,1,13,0,0,46,6,52
2023/3/12 8:10,1,13,0,0,40,3,43
2023/3/12 8:20,1,13,0,0,29,0,29
2023/3/12 8:30,1,13,0,0,31,3,34
2023/3/12 8:40,1,14,0,0,30,4,34
2023/3/12 8:50,1,14,0,0,35,4,39
2023/3/12 9:00,1,14,0,0,31,3,34
2023/3/12 9:10,1,14,0,0,37,7,44
2023/3/12 9:20,1,14,0,0,37,5,42
2023/3/12 9:30,1,15,0,0,36,12,48
2023/3/12 9:40,1,15,0,0,39,15,54
2023/3/12 9:50,1,15,0,0,41,8,49
2023/3/12 10:00,1,15,0,0,30,19,49
2023/3/12 10:10,1,15,0,0,27,13,40
2023/3/12 10:20,1,15,0,0,20,9,29
2023/3/12 10:30,1,15,0,0,20,10,30
2023/3/12 10:40,1,15,0,0,21,15,36
2023/3/12 10:50,1,16,0,0,18,16,34
2023/3/12 11:00,1,16,0,0,13,18,31
2023/3/12 11:10,1,16,0,0,14,15,29
2023/3/12 11:20,1,16,0,0,14,21,35
2023/3/12 11:30,1,16,0,0,13,21,34
2023/3/12 11:40,1,16,0,0,12,22,34
2023/3/12 11:50,1,16,0,0,12,33,45
2023/3/12 12:00,1,17,0,0,12,37,49
2023/3/12 12:10,1,17,0,0,12,26,38
2023/3/12 12:20,1,17,0,0,13,28,41
2023/3/12 12:30,1,17,0,0,15,34,49
2023/3/12 12:40,1,17,0,0,10,34,44
2023/3/12 12:50,1,18,0,0,8,29,37
2023/3/12 13:00,1,18,0,0,11,22,33
2023/3/12 13:10,1,18,0,0,13,18,31
2023/3/12 13:20,1,18,0,0,16,16,32
2023/3/12 13:30,1,18,0,0,15,15,30
2023/3/12 13:40,1,18,0,0,29,15,44
2023/3/12 13:50,1,18,0,0,23,17,40
2023/3/12 14:00,1,18,0,0,24,18,42
2023/3/12 14:10,1,19,0,0,20,21,41
2023/3/12 14:20,1,19,0,0,14,14,28
2023/3/12 14:30,1,19,0,0,15,14,29
2023/3/12 14:40,1,19,0,0,18,16,34
2023/3/12 14:50,1,19,0,0,19,14,33
2023/3/12 15:00,1,19,0,0,23,12,35
2023/3/12 15:10,1,19,0,0,26,12,38
2023/3/12 15:20,1,19,0,0,23,12,35
2023/3/12 15:30,1,19,0,0,28,18,46
2023/3/12 15:40,1,19,0,0,22,17,39
2023/3/12 15:50,1,19,0,0,29,16,45
2023/3/12 16:00,1,19,0,0,24,15,39
2023/3/12 16:10,1,18,0,0,24,16,40
2023/3/12 16:20,1,18,0,0,26,12,38
2023/3/12 16:30,1,18,0,0,30,13,43
2023/3/12 16:40,1,18,0,0,25,13,38
2023/3/12 16:50,1,18,0,0,32,16,48
2023/3/12 17:00,1,18,0,0,40,15,55
2023/3/12 17:10,1,18,0,0,28,23,51
2023/3/12 17:20,1,17,0,0,42,19,61
2023/3/12 17:30,1,17,0,0,34,23,57
2023/3/12 17:40,1,17,0,0,39,31,70
2023/3/12 17:50,1,17,0,0,35,33,68
2023/3/12 18:00,1,17,0,0,50,30,80
2023/3/12 18:10,1,17,0,0,41,31,72
2023/3/12 18:20,1,17,0,0,38,29,67
2023/3/12 18:30,1,16,0,0,42,30,72
2023/3/12 18:40,1,16,0,0,39,28,67
2023/3/12 18:50,1,16,0,0,37,31,68
2023/3/12 19:00,1,16,0,0,36,22,58
2023/3/12 19:10,1,16,0,0,28,23,51
2023/3/12 19:20,1,16,0,0,22,18,40
2023/3/12 19:30,1,16,0,0,25,20,45
2023/3/12 19:40,1,15,0,0,24,17,41
2023/3/12 19:50,1,15,0,0,24,15,39
2023/3/12 20:00,1,15,0,0,22,24,46
2023/3/12 20:10,1,15,0,0,20,22,42
2023/3/12 20:20,1,14,0,0,14,22,36
2023/3/12 20:30,1,14,0,0,14,29,43
2023/3/12 20:40,1,14,0,0,18,32,50
2023/3/12 20:50,1,14,0,0,15,34,49
2023/3/12 21:00,1,14,0,0,13,32,45
2023/3/12 21:10,1,14,0,0,17,30,47
2023/3/12 21:20,1,14,0,0,12,26,38
2023/3/12 21:30,1,14,0,0,12,21,33
2023/3/12 21:40,1,13,0,0,9,43,52
2023/3/12 21:50,1,13,0,0,10,42,52
2023/3/12 22:00,1,13,0,0,5,33,38
2023/3/12 22:10,1,13,0,0,5,35,40
2023/3/12 22:20,1,13,0,0,4,28,32
2023/3/12 22:30,1,13,0,0,3,19,22
2023/3/12 22:40,1,12,0,0,2,12,14
2023/3/12 22:50,1,12,0,0,2,9,11
2023/3/12 23:00,1,12,0,0,2,7,9
2023/3/12 23:10,1,12,0,0,1,4,5
2023/3/12 23:20,1,12,0,0,1,2,3
2023/3/12 23:30,1,11,0,0,1,1,2
2023/3/12 23:40,1,11,0,0,2,3,5
2023/3/12 23:50,1,11,0,0,0,1,1
2023/3/13 0:00,1,11,1,0,3,2,5
2023/3/13 0:10,1,11,1,0,3,0,3
2023/3/13 0:20,1,11,1,0,2,3,5
2023/3/13 0:30,1,11,1,0,2,0,2
2023/3/13 0:40,1,11,1,0,3,2,5
2023/3/13 0:50,1,11,1,0,1,2,3
2023/3/13 1:00,1,11,1,0,2,2,4
2023/3/13 1:10,1,10,1,0,2,1,3
2023/3/13 1:20,1,10,1,0,1,2,3
2023/3/13 1:30,1,10,1,0,0,1,1
2023/3/13 1:40,1,10,1,0,2,0,2
2023/3/13 1:50,1,10,1,0,0,0,0
2023/3/13 2:00,1,9,1,0,0,0,0
2023/3/13 2:10,1,9,1,0,1,0,1
2023/3/13 2:20,1,9,1,0,2,2,4
2023/3/13 2:30,1,9,1,0,0,0,0
2023/3/13 2:40,1,9,1,0,1,0,1
2023/3/13 2:50,1,9,1,0,1,1,2
2023/3/13 3:00,1,9,1,0,2,0,2
2023/3/13 3:10,1,9,1,0,2,0,2
2023/3/13 3:20,1,8,1,0,0,1,1
2023/3/13 3:30,1,8,1,0,1,1,2
2023/3/13 3:40,1,8,1,0,2,2,4
2023/3/13 3:50,1,8,1,0,1,0,1
2023/3/13 4:00,1,8,1,0,1,0,1
2023/3/13 4:10,1,8,1,0,0,1,1
2023/3/13 4:20,1,8,1,0,2,1,3
2023/3/13 4:30,1,8,1,0,2,0,2
2023/3/13 4:40,1,8,1,0,0,1,1
2023/3/13 4:50,1,8,1,0,1,1,2
2023/3/13 5:00,1,8,1,0,1,0,1
2023/3/13 5:10,1,8,1,0,1,2,3
2023/3/13 5:20,1,8,1,0,2,0,2
2023/3/13 5:30,1,9,1,0,1,2,3
2023/3/13 5:40,1,9,1,0,2,1,3
2023/3/13 5:50,1,9,1,0,5,2,7
2023/3/13 6:00,1,9,1,0,4,2,6
2023/3/13 6:10,1,9,1,0,2,2,4
2023/3/13 6:20,1,9,1,0,6,3,9
2023/3/13 6:30,1,9,1,0,5,4,9
2023/3/13 6:40,1,10,1,0,11,2,13
2023/3/13 6:50,1,10,1,0,34,2,36
2023/3/13 7:00,1,10,1,0,66,3,69
2023/3/13 7:10,1,10,1,0,80,2,82
2023/3/13 7:20,1,10,1,0,114,3,117
2023/3/13 7:30,1,11,1,0,315,1,316
2023/3/13 7:40,1,11,1,0,518,5,523
2023/3/13 7:50,1,11,1,0,565,3,568
2023/3/13 8:00,1,11,1,0,326,6,332
2023/3/13 8:10,1,12,1,0,130,12,142
2023/3/13 8:20,1,12,1,0,90,8,98
2023/3/13 8:30,1,13,1,0,84,15,99
2023/3/13 8:40,1,13,1,0,72,13,85
2023/3/13 8:50,1,13,1,0,78,13,91
2023/3/13 9:00,1,13,1,0,79,13,92
2023/3/13 9:10,1,13,1,0,86,18,104
2023/3/13 9:20,1,13,1,0,139,30,169
2023/3/13 9:30,1,14,1,0,211,43,254
2023/3/13 9:40,1,14,1,0,240,117,357
2023/3/13 9:50,1,14,1,0,189,176,365
2023/3/13 10:00,1,14,1,0,145,144,289
2023/3/13 10:10,1,14,1,0,91,87,178
2023/3/13 10:20,1,15,1,0,67,72,139
2023/3/13 10:30,1,15,1,0,60,45,105
2023/3/13 10:40,1,15,1,0,70,49,119
2023/3/13 10:50,1,15,1,0,75,43,118
2023/3/13 11:00,1,15,1,0,70,40,110
2023/3/13 11:10,1,16,1,0,58,39,97
2023/3/13 11:20,1,16,1,0,63,47,110
2023/3/13 11:30,1,16,1,0,60,72,132
2023/3/13 11:40,1,16,1,0,70,212,282
2023/3/13 11:50,1,16,1,0,71,252,323
2023/3/13 12:00,1,17,1,0,63,246,309
2023/3/13 12:10,1,17,1,0,59,191,250
2023/3/13 12:20,1,17,1,0,67,120,187
2023/3/13 12:30,1,17,1,0,66,81,147
2023/3/13 12:40,1,17,1,0,60,69,129
2023/3/13 12:50,1,17,1,0,63,48,111
2023/3/13 13:00,1,18,1,0,61,27,88
2023/3/13 13:10,1,18,1,0,62,34,96
2023/3/13 13:20,1,18,1,0,84,32,116
2023/3/13 13:30,1,18,1,0,177,35,212
2023/3/13 13:40,1,18,1,0,253,32,285
2023/3/13 13:50,1,18,1,0,256,35,291
2023/3/13 14:00,1,18,1,0,112,28,140
2023/3/13 14:10,1,19,1,0,94,39,133
2023/3/13 14:20,1,19,1,0,98,44,142
2023/3/13 14:30,1,19,1,0,84,40,124
2023/3/13 14:40,1,19,1,0,69,49,118
2023/3/13 14:50,1,19,1,0,65,41,106
2023/3/13 15:00,1,20,1,0,73,45,118
2023/3/13 15:10,1,20,1,0,78,45,123
2023/3/13 15:20,1,20,1,0,77,38,115
2023/3/13 15:30,1,21,1,0,85,63,148
2023/3/13 15:40,1,21,1,0,133,190,323
2023/3/13 15:50,1,21,1,0,171,210,381
2023/3/13 16:00,1,21,1,0,94,153,247
2023/3/13 16:10,1,21,1,0,91,131,222
2023/3/13 16:20,1,21,1,0,70,76,146
2023/3/13 16:30,1,21,1,0,65,60,125
2023/3/13 16:40,1,21,1,0,66,53,119
2023/3/13 16:50,1,21,1,0,68,67,135
2023/3/13 17:00,1,21,1,0,83,64,147
2023/3/13 17:10,1,21,1,0,78,60,138
2023/3/13 17:20,1,21,1,0,83,60,143
2023/3/13 17:30,1,21,1,0,81,86,167
2023/3/13 17:40,1,21,1,0,81,246,327
2023/3/13 17:50,1,21,1,0,91,283,374
2023/3/13 18:00,1,21,1,0,83,194,277
2023/3/13 18:10,1,21,1,0,82,139,221
2023/3/13 18:20,1,20,1,0,82,108,190
2023/3/13 18:30,1,20,1,0,121,89,210
2023/3/13 18:40,1,20,1,0,175,77,252
2023/3/13 18:50,1,20,1,0,177,71,248
2023/3/13 19:00,1,20,1,0,141,61,202
2023/3/13 19:10,1,19,1,0,124,54,178
2023/3/13 19:20,1,19,1,0,103,56,159
2023/3/13 19:30,1,19,1,0,87,56,143
2023/3/13 19:40,1,19,1,0,88,55,143
2023/3/13 19:50,1,19,1,0,75,56,131
2023/3/13 20:00,1,19,1,0,73,60,133
2023/3/13 20:10,1,19,1,0,91,59,150
2023/3/13 20:20,1,19,1,0,76,58,134
2023/3/13 20:30,1,19,1,0,67,92,159
2023/3/13 20:40,1,19,1,0,65,190,255
2023/3/13 20:50,1,19,1,0,48,225,273
2023/3/13 21:00,1,19,1,0,53,143,196
2023/3/13 21:10,1,18,1,0,47,135,182
2023/3/13 21:20,1,18,1,0,30,102,132
2023/3/13 21:30,1,18,1,0,21,61,82
2023/3/13 21:40,1,18,1,0,18,77,95
2023/3/13 21:50,1,18,1,0,20,74,94
2023/3/13 22:00,1,18,1,0,14,79,93
2023/3/13 22:10,1,18,1,0,15,70,85
2023/3/13 22:20,1,18,1,0,15,54,69
2023/3/13 22:30,1,18,1,0,15,37,52
2023/3/13 22:40,1,18,1,0,11,22,33
2023/3/13 22:50,1,18,1,0,11,13,24
2023/3/13 23:00,1,18,1,0,12,12,24
2023/3/13 23:10,1,17,1,0,7,13,20
2023/3/13 23:20,1,17,1,0,6,9,15
2023/3/13 23:30,1,17,1,0,1,7,8
2023/3/13 23:40,1,17,1,0,3,10,13
2023/3/13 23:50,1,17,1,0,2,5,7
2023/3/14 0:00,1,16,1,0,4,0,4
2023/3/14 0:10,1,16,1,0,3,0,3
2023/3/14 0:20,1,16,1,0,3,3,6
2023/3/14 0:30,1,16,1,0,2,0,2
2023/3/14 0:40,1,16,1,0,3,0,3
2023/3/14 0:50,1,16,1,0,2,2,4
2023/3/14 1:00,1,16,1,0,1,0,1
2023/3/14 1:10,1,16,1,0,1,0,1
2023/3/14 1:20,1,16,1,0,1,1,2
2023/3/14 1:30,1,16,1,0,0,0,0
2023/3/14 1:40,1,16,1,0,1,0,1
2023/3/14 1:50,1,16,1,0,1,2,3
2023/3/14 2:00,1,15,1,0,2,0,2
2023/3/14 2:10,1,15,1,0,2,2,4
2023/3/14 2:20,1,15,1,0,0,0,0
2023/3/14 2:30,1,15,1,0,2,1,3
2023/3/14 2:40,1,15,1,0,1,2,3
2023/3/14 2:50,1,14,1,0,0,0,0
2023/3/14 3:00,1,14,1,0,0,0,0
2023/3/14 3:10,1,14,1,0,2,0,2
2023/3/14 3:20,1,14,1,0,1,0,1
2023/3/14 3:30,1,14,1,0,0,2,2
2023/3/14 3:40,1,14,1,0,2,2,4
2023/3/14 3:50,1,14,1,0,0,2,2
2023/3/14 4:00,1,14,1,0,2,2,4
2023/3/14 4:10,1,14,1,0,0,2,2
2023/3/14 4:20,1,14,1,0,0,2,2
2023/3/14 4:30,1,14,1,0,1,1,2
2023/3/14 4:40,1,14,1,0,2,1,3
2023/3/14 4:50,1,15,1,0,0,0,0
2023/3/14 5:00,1,15,1,0,1,0,1
2023/3/14 5:10,1,15,1,0,2,0,2
2023/3/14 5:20,1,15,1,0,1,1,2
2023/3/14 5:30,1,15,1,0,1,1,2
2023/3/14 5:40,1,15,1,0,0,2,2
2023/3/14 5:50,1,15,1,0,5,0,5
2023/3/14 6:00,1,16,1,0,4,3,7
2023/3/14 6:10,1,16,1,0,4,2,6
2023/3/14 6:20,1,16,1,0,4,1,5
2023/3/14 6:30,1,16,1,0,4,3,7
2023/3/14 6:40,1,16,1,0,11,2,13
2023/3/14 6:50,1,16,1,0,33,0,33
2023/3/14 7:00,1,17,1,0,64,3,67
2023/3/14 7:10,1,17,1,0,86,1,87
2023/3/14 7:20,1,17,1,0,108,1,109
2023/3/14 7:30,1,17,1,0,312,2,314
2023/3/14 7:40,1,17,1,0,518,5,523
2023/3/14 7:50,1,17,1,0,676,6,682
2023/3/14 8:00,1,17,1,0,279,7,286
2023/3/14 8:10,1,18,1,0,134,8,142
2023/3/14 8:20,1,18,1,0,98,11,109
2023/3/14 8:30,1,18,1,0,75,11,86
2023/3/14 8:40,1,18,1,0,81,12,93
2023/3/14 8:50,1,18,1,0,72,11,83
2023/3/14 9:00,1,18,1,0,80,17,97
2023/3/14 9:10,1,19,1,0,75,18,93
2023/3/14 9:20,1,19,1,0,162,31,193
2023/3/14 9:30,1,19,1,0,243,47,290
2023/3/14 9:40,1,19,1,0,277,118,395
2023/3/14 9:50,1,19,1,0,188,167,355
2023/3/14 10:00,1,19,1,0,132,153,285
2023/3/14 10:10,1,19,1,0,79,104,183
2023/3/14 10:20,1,20,1,0,86,73,159
2023/3/14 10:30,1,20,1,0,66,45,111
2023/3/14 10:40,1,20,1,0,62,46,108
2023/3/14 10:50,1,20,1,0,76,40,116
2023/3/14 11:00,1,21,1,0,63,34,97
2023/3/14 11:10,1,21,1,0,57,35,92
2023/3/14 11:20,1,21,1,0,54,42,96
2023/3/14 11:30,1,21,1,0,61,70,131
2023/3/14 11:40,1,21,1,0,70,222,292
2023/3/14 11:50,1,21,1,0,64,265,329
2023/3/14 12:00,1,22,1,0,52,234,286
2023/3/14 12:10,1,22,1,0,60,179,239
2023/3/14 12:20,1,22,1,0,59,123,182
2023/3/14 12:30,1,22,1,0,59,82,141
2023/3/14 12:40,1,22,1,0,60,70,130
2023/3/14 12:50,1,22,1,0,63,49,112
2023/3/14 13:00,1,23,1,0,57,26,83
2023/3/14 13:10,1,23,1,0,62,32,94
2023/3/14 13:20,1,23,1,0,93,30,123
2023/3/14 13:30,1,23,1,0,177,34,211
2023/3/14 13:40,1,23,1,0,234,40,274
2023/3/14 13:50,1,23,1,0,259,34,293
2023/3/14 14:00,1,24,1,0,137,27,164
2023/3/14 14:10,1,24,1,0,116,39,155
2023/3/14 14:20,1,24,1,0,91,39,130
2023/3/14 14:30,1,24,1,0,82,40,122
2023/3/14 14:40,1,24,1,0,80,40,120
2023/3/14 14:50,1,24,1,0,62,46,108
2023/3/14 15:00,1,25,1,0,68,42,110
2023/3/14 15:10,1,25,1,0,72,40,112
2023/3/14 15:20,1,25,1,0,86,39,125
2023/3/14 15:30,1,25,1,0,88,62,150
2023/3/14 15:40,1,25,1,0,135,167,302
2023/3/14 15:50,1,25,1,0,167,190,357
2023/3/14 16:00,1,25,1,0,116,133,249
2023/3/14 16:10,1,25,1,0,90,121,211
2023/3/14 16:20,1,25,1,0,70,82,152
2023/3/14 16:30,1,25,1,0,82,62,144
2023/3/14 16:40,1,25,1,0,78,65,143
2023/3/14 16:50,1,24,1,0,82,60,142
2023/3/14 17:00,1,24,1,0,74,55,129
2023/3/14 17:10,1,23,1,0,63,49,112
2023/3/14 17:20,1,23,1,0,80,51,131
2023/3/14 17:30,1,23,1,0,78,90,168
2023/3/14 17:40,1,23,1,0,88,221,309
2023/3/14 17:50,1,23,1,0,84,272,356
2023/3/14 18:00,1,23,1,0,97,218,315
2023/3/14 18:10,1,22,1,0,77,136,213
2023/3/14 18:20,1,22,1,0,95,106,201
2023/3/14 18:30,1,22,1,0,100,78,178
2023/3/14 18:40,1,22,1,0,193,80,273
2023/3/14 18:50,1,22,1,0,186,72,258
2023/3/14 19:00,1,22,1,0,142,56,198
2023/3/14 19:10,1,22,1,0,119,66,185
2023/3/14 19:20,1,22,1,0,88,65,153
2023/3/14 19:30,1,22,1,0,97,63,160
2023/3/14 19:40,1,22,1,0,89,61,150
2023/3/14 19:50,1,21,1,0,84,64,148
2023/3/14 20:00,1,21,1,0,74,66,140
2023/3/14 20:10,1,21,1,0,78,66,144
2023/3/14 20:20,1,21,1,0,87,63,150
2023/3/14 20:30,1,21,1,0,62,104,166
2023/3/14 20:40,1,21,1,0,70,171,241
2023/3/14 20:50,1,20,1,0,53,263,316
2023/3/14 21:00,1,20,1,0,50,175,225
2023/3/14 21:10,1,20,1,0,46,122,168
2023/3/14 21:20,1,20,1,0,33,97,130
2023/3/14 21:30,1,20,1,0,26,65,91
2023/3/14 21:40,1,20,1,0,20,73,93
2023/3/14 21:50,1,19,1,0,19,89,108
2023/3/14 22:00,1,19,1,0,15,93,108
2023/3/14 22:10,1,19,1,0,14,84,98
2023/3/14 22:20,1,19,1,0,17,47,64
2023/3/14 22:30,1,19,1,0,16,34,50
2023/3/14 22:40,1,18,1,0,12,18,30
2023/3/14 22:50,1,18,1,0,12,15,27
2023/3/14 23:00,1,18,1,0,8,10,18
2023/3/14 23:10,1,18,1,0,5,12,17
2023/3/14 23:20,1,18,1,0,4,9,13
2023/3/14 23:30,1,17,1,0,3,8,11
2023/3/14 23:40,1,17,1,0,1,9,10
2023/3/14 23:50,1,17,1,0,1,3,4
2023/3/15 0:00,1,17,1,0,3,1,4
2023/3/15 0:10,1,17,1,0,3,0,3
2023/3/15 0:20,1,17,1,0,4,3,7
2023/3/15 0:30,1,17,1,0,0,2,2
2023/3/15 0:40,1,16,1,0,2,2,4
2023/3/15 0:50,1,16,1,0,0,1,1
2023/3/15 1:00,1,16,1,0,1,2,3
2023/3/15 1:10,1,16,1,0,2,2,4
2023/3/15 1:20,1,16,1,0,0,0,0
2023/3/15 1:30,1,16,1,0,2,2,4
2023/3/15 1:40,1,16,1,0,2,2,4
2023/3/15 1:50,1,16,1,0,2,2,4
2023/3/15 2:00,1,15,1,0,2,1,3
2023/3/15 2:10,1,15,1,0,2,1,3
2023/3/15 2:20,1,15,1,0,2,0,2
2023/3/15 2:30,1,14,1,0,2,2,4
2023/3/15 2:40,1,14,1,0,2,2,4
2023/3/15 2:50,1,14,1,0,1,2,3
2023/3/15 3:00,1,14,1,0,1,2,3
2023/3/15 3:10,1,14,1,0,0,0,0
2023/3/15 3:20,1,14,1,0,1,2,3
2023/3/15 3:30,1,14,1,0,0,0,0
2023/3/15 3:40,1,14,1,0,1,2,3
2023/3/15 3:50,1,14,1,0,2,2,4
2023/3/15 4:00,1,14,1,0,0,2,2
2023/3/15 4:10,1,14,1,0,0,1,1
2023/3/15 4:20,1,14,1,0,1,2,3
2023/3/15 4:30,1,15,1,0,0,1,1
2023/3/15 4:40,1,15,1,0,0,2,2
2023/3/15 4:50,1,15,1,0,1,2,3
2023/3/15 5:00,1,15,1,0,0,2,2
2023/3/15 5:10,1,15,1,0,0,2,2
2023/3/15 5:20,1,16,1,0,2,0,2
2023/3/15 5:30,1,16,1,0,2,2,4
2023/3/15 5:40,1,16,1,0,2,1,3
2023/3/15 5:50,1,17,1,0,5,1,6
2023/3/15 6:00,1,17,1,0,3,4,7
2023/3/15 6:10,1,17,1,0,4,1,5
2023/3/15 6:20,1,17,1,0,6,1,7
2023/3/15 6:30,1,17,1,0,7,3,10
2023/3/15 6:40,1,18,1,0,14,1,15
2023/3/15 6:50,1,18,1,0,40,2,42
2023/3/15 7:00,1,18,1,0,64,2,66
2023/3/15 7:10,1,18,1,0,93,2,95
2023/3/15 7:20,1,19,1,0,99,1,100
2023/3/15 7:30,1,19,1,0,278,2,280
2023/3/15 7:40,1,19,1,0,584,5,589
2023/3/15 7:50,1,19,1,0,643,5,648
2023/3/15 8:00,1,19,1,0,326,5,331
2023/3/15 8:10,1,19,1,0,130,12,142
2023/3/15 8:20,1,20,1,0,101,10,111
2023/3/15 8:30,1,20,1,0,88,13,101
2023/3/15 8:40,1,20,1,0,89,15,104
2023/3/15 8:50,1,20,1,0,77,10,87
2023/3/15 9:00,1,20,1,0,76,13,89
2023/3/15 9:10,1,20,1,0,88,20,108
2023/3/15 9:20,1,20,1,0,167,27,194
2023/3/15 9:30,1,21,1,0,230,37,267
2023/3/15 9:40,1,21,1,0,240,126,366
2023/3/15 9:50,1,21,1,0,187,172,359
2023/3/15 10:00,1,21,1,0,152,141,293
2023/3/15 10:10,1,21,1,0,83,101,184
2023/3/15 10:20,1,21,1,0,71,79,150
2023/3/15 10:30,1,21,1,0,56,48,104
2023/3/15 10:40,1,22,1,0,69,41,110
2023/3/15 10:50,1,22,1,0,68,44,112
2023/3/15 11:00,1,22,1,0,69,39,108
2023/3/15 11:10,1,22,1,0,64,43,107
2023/3/15 11:20,1,22,1,0,56,42,98
2023/3/15 11:30,1,22,1,0,69,74,143
2023/3/15 11:40,1,23,1,0,69,221,290
2023/3/15 11:50,1,23,1,0,67,302,369
2023/3/15 12:00,1,23,1,0,51,271,322
2023/3/15 12:10,1,24,1,0,59,179,238
2023/3/15 12:20,1,24,1,0,56,136,192
2023/3/15 12:30,1,24,1,0,44,87,131
2023/3/15 12:40,1,24,1,0,30,65,95
2023/3/15 12:50,1,24,1,0,17,55,72
2023/3/15 13:00,1,24,1,0,19,29,48
2023/3/15 13:10,1,25,1,0,11,20,31
2023/3/15 13:20,1,25,1,0,13,17,30
2023/3/15 13:30,1,25,1,0,16,17,33
2023/3/15 13:40,1,26,1,0,27,19,46
2023/3/15 13:50,1,27,1,0,28,23,51
2023/3/15 14:00,1,27,1,0,26,25,51
2023/3/15 14:10,1,27,1,0,23,23,46
2023/3/15 14:20,1,27,1,0,18,18,36
2023/3/15 14:30,1,28,1,0,15,17,32
2023/3/15 14:40,1,28,1,0,21,15,36
2023/3/15 14:50,1,28,1,0,23,15,38
2023/3/15 15:00,1,28,1,0,25,11,36
2023/3/15 15:10,1,27,1,0,33,17,50
2023/3/15 15:20,1,27,1,0,29,18,47
2023/3/15 15:30,1,27,1,0,32,17,49
2023/3/15 15:40,1,27,1,0,28,25,53
2023/3/15 15:50,1,27,1,0,31,20,51
2023/3/15 16:00,1,27,1,0,27,20,47
2023/3/15 16:10,1,27,1,0,27,16,43
2023/3/15 16:20,1,26,1,0,28,17,45
2023/3/15 16:30,1,26,1,0,40,13,53
2023/3/15 16:40,1,26,1,0,37,11,48
2023/3/15 16:50,1,26,1,0,38,18,56
2023/3/15 17:00,1,25,1,0,44,20,64
2023/3/15 17:10,1,25,1,0,43,24,67
2023/3/15 17:20,1,25,1,0,42,22,64
2023/3/15 17:30,1,25,1,0,37,32,69
2023/3/15 17:40,1,25,1,0,46,36,82
2023/3/15 17:50,1,24,1,0,43,37,80
2023/3/15 18:00,1,24,1,0,58,40,98
2023/3/15 18:10,1,23,1,0,56,39,95
2023/3/15 18:20,1,23,1,0,50,34,84
2023/3/15 18:30,1,23,1,0,49,37,86
2023/3/15 18:40,1,23,1,0,49,33,82
2023/3/15 18:50,1,23,1,0,52,32,84
2023/3/15 19:00,1,23,1,0,35,23,58
2023/3/15 19:10,1,22,1,0,35,25,60
2023/3/15 19:20,1,21,1,0,30,20,50
2023/3/15 19:30,1,21,1,0,27,23,50
2023/3/15 19:40,1,21,1,0,27,22,49
2023/3/15 19:50,1,21,1,0,22,18,40
2023/3/15 20:00,1,21,1,0,25,27,52
2023/3/15 20:10,1,20,1,0,24,22,46
2023/3/15 20:20,1,20,1,0,20,32,52
2023/3/15 20:30,1,19,1,0,18,31,49
2023/3/15 20:40,1,19,1,0,20,38,58
2023/3/15 20:50,1,19,1,0,19,39,58
2023/3/15 21:00,1,18,1,0,12,43,55
2023/3/15 21:10,1,18,1,0,16,27,43
2023/3/15 21:20,1,18,1,0,14,26,40
2023/3/15 21:30,1,18,1,0,11,27,38
2023/3/15 21:40,1,17,1,0,9,42,51
2023/3/15 21:50,1,17,1,0,12,44,56
2023/3/15 22:00,1,16,1,0,5,42,47
2023/3/15 22:10,1,15,1,0,3,37,40
2023/3/15 22:20,1,15,1,0,4,36,40
2023/3/15 22:30,1,14,1,0,3,20,23
2023/3/15 22:40,1,14,1,0,3,14,17
2023/3/15 22:50,1,14,1,0,2,9,11
2023/3/15 23:00,1,14,1,0,3,5,8
2023/3/15 23:10,1,14,1,0,3,6,9
2023/3/15 23:20,1,14,1,0,0,2,2
2023/3/15 23:30,1,14,1,0,2,0,2
2023/3/15 23:40,1,13,1,0,0,1,1
2023/3/15 23:50,1,13,1,0,2,0,2
2023/3/16 0:00,1,12,1,0,5,0,5
2023/3/16 0:10,1,12,1,0,3,2,5
2023/3/16 0:20,1,12,1,0,2,3,5
2023/3/16 0:30,1,12,1,0,0,1,1
2023/3/16 0:40,1,12,1,0,1,2,3
2023/3/16 0:50,1,12,1,0,0,2,2
2023/3/16 1:00,1,12,1,0,1,0,1
2023/3/16 1:10,1,11,1,0,2,2,4
2023/3/16 1:20,1,11,1,0,2,2,4
2023/3/16 1:30,1,11,1,0,2,2,4
2023/3/16 1:40,1,10,1,0,2,1,3
2023/3/16 1:50,1,10,1,0,1,1,2
2023/3/16 2:00,1,10,1,0,1,0,1
2023/3/16 2:10,1,9,1,0,0,1,1
2023/3/16 2:20,1,9,1,0,1,0,1
2023/3/16 2:30,1,9,1,0,2,0,2
2023/3/16 2:40,1,8,1,0,1,0,1
2023/3/16 2:50,1,7,1,0,1,2,3
2023/3/16 3:00,1,7,1,0,2,0,2
2023/3/16 3:10,1,7,1,0,2,2,4
2023/3/16 3:20,1,7,1,0,1,1,2
2023/3/16 3:30,1,7,1,0,0,0,0
2023/3/16 3:40,1,7,1,0,0,1,1
2023/3/16 3:50,1,7,1,0,1,2,3
2023/3/16 4:00,1,7,1,0,0,0,0
2023/3/16 4:10,1,7,1,0,1,0,1
2023/3/16 4:20,1,7,1,0,0,2,2
2023/3/16 4:30,1,7,1,0,1,1,2
2023/3/16 4:40,1,7,1,0,1,0,1
2023/3/16 4:50,1,7,1,0,0,1,1
2023/3/16 5:00,1,7,1,0,0,0,0
2023/3/16 5:10,1,7,1,0,2,2,4
2023/3/16 5:20,1,8,1,0,0,0,0
2023/3/16 5:30,1,8,1,0,2,1,3
2023/3/16 5:40,1,8,1,0,0,0,0
2023/3/16 5:50,1,8,1,0,4,2,6
2023/3/16 6:00,1,8,1,0,2,4,6
2023/3/16 6:10,1,8,1,0,3,2,5
2023/3/16 6:20,1,9,1,0,5,2,7
2023/3/16 6:30,1,9,1,0,7,3,10
2023/3/16 6:40,1,9,1,0,11,2,13
2023/3/16 6:50,1,9,1,0,37,0,37
2023/3/16 7:00,1,9,1,0,68,2,70
2023/3/16 7:10,1,9,1,0,90,1,91
2023/3/16 7:20,1,10,1,0,97,1,98
2023/3/16 7:30,1,10,1,0,298,2,300
2023/3/16 7:40,1,10,1,0,563,5,568
2023/3/16 7:50,1,10,1,0,665,6,671
2023/3/16 8:00,1,10,1,0,307,8,315
2023/3/16 8:10,1,10,1,0,133,8,141
2023/3/16 8:20,1,10,1,0,87,10,97
2023/3/16 8:30,1,10,1,0,92,12,104
2023/3/16 8:40,1,10,1,0,76,14,90
2023/3/16 8:50,1,10,1,0,72,13,85
2023/3/16 9:00,1,10,1,0,88,15,103
2023/3/16 9:10,1,11,1,0,90,15,105
2023/3/16 9:20,1,11,1,0,137,31,168
2023/3/16 9:30,1,11,1,0,246,46,292
2023/3/16 9:40,1,11,1,0,255,137,392
2023/3/16 9:50,1,12,1,0,178,166,344
2023/3/16 10:00,1,12,1,0,134,140,274
2023/3/16 10:10,1,12,1,0,82,94,176
2023/3/16 10:20,1,12,1,0,80,70,150
2023/3/16 10:30,1,12,1,0,58,47,105
2023/3/16 10:40,1,12,1,0,58,42,100
2023/3/16 10:50,1,13,1,0,77,38,115
2023/3/16 11:00,1,13,1,0,65,43,108
2023/3/16 11:10,1,13,1,0,65,35,100
2023/3/16 11:20,1,13,1,0,68,41,109
2023/3/16 11:30,1,13,1,0,72,64,136
2023/3/16 11:40,1,13,1,0,71,244,315
2023/3/16 11:50,1,13,1,0,67,316,383
2023/3/16 12:00,1,13,1,0,64,265,329
2023/3/16 12:10,1,13,1,0,51,179,230
2023/3/16 12:20,1,13,1,0,53,108,161
2023/3/16 12:30,1,13,1,0,56,81,137
2023/3/16 12:40,1,13,1,0,59,67,126
2023/3/16 12:50,1,13,1,0,67,55,122
2023/3/16 13:00,1,14,1,0,59,29,88
2023/3/16 13:10,1,14,1,0,56,29,85
2023/3/16 13:20,1,14,1,0,92,33,125
2023/3/16 13:30,1,14,1,0,143,32,175
2023/3/16 13:40,1,14,1,0,243,35,278
2023/3/16 13:50,1,15,1,0,241,35,276
2023/3/16 14:00,0,15,1,0,23,7,30
2023/3/16 14:10,0,15,1,0,23,7,30
2023/3/16 14:20,0,16,1,0,22,7,29
2023/3/16 14:30,0,16,1,0,19,9,28
2023/3/16 14:40,0,16,1,0,15,9,24
2023/3/16 14:50,0,16,1,0,15,9,24
2023/3/16 15:00,0,16,1,0,15,9,24
2023/3/16 15:10,0,16,1,0,14,8,22
2023/3/16 15:20,0,16,1,0,17,7,24
2023/3/16 15:30,0,16,1,0,18,12,30
2023/3/16 15:40,0,16,1,0,29,35,64
2023/3/16 15:50,0,15,1,0,32,40,72
2023/3/16 16:00,0,15,1,0,18,28,46
2023/3/16 16:10,0,15,1,0,19,24,43
2023/3/16 16:20,0,15,1,0,16,16,32
2023/3/16 16:30,0,15,1,0,16,14,30
2023/3/16 16:40,0,15,1,0,14,12,26
2023/3/16 16:50,0,15,1,0,16,11,27
2023/3/16 17:00,0,15,1,0,14,12,26
2023/3/16 17:10,0,14,1,0,13,12,25
2023/3/16 17:20,0,14,1,0,15,10,25
2023/3/16 17:30,0,14,1,0,18,16,34
2023/3/16 17:40,0,14,1,0,16,53,69
2023/3/16 17:50,0,14,1,0,18,49,67
2023/3/16 18:00,0,14,1,0,19,42,61
2023/3/16 18:10,0,14,1,0,16,30,46
2023/3/16 18:20,0,14,1,0,18,21,39
2023/3/16 18:30,0,14,1,0,23,15,38
2023/3/16 18:40,0,13,1,0,39,15,54
2023/3/16 18:50,0,13,1,0,29,15,44
2023/3/16 19:00,0,13,1,0,23,12,35
2023/3/16 19:10,0,13,1,0,27,11,38
2023/3/16 19:20,0,12,1,0,18,11,29
2023/3/16 19:30,0,12,1,0,17,12,29
2023/3/16 19:40,0,12,1,0,19,13,32
2023/3/16 19:50,0,12,1,0,18,12,30
2023/3/16 20:00,0,12,1,0,18,12,30
2023/3/16 20:10,0,12,1,0,14,14,28
2023/3/16 20:20,0,12,1,0,14,13,27
2023/3/16 20:30,0,12,1,0,12,17,29
2023/3/16 20:40,0,11,1,0,11,42,53
2023/3/16 20:50,0,11,1,0,11,55,66
2023/3/16 21:00,0,11,1,0,9,36,45
2023/3/16 21:10,0,11,1,0,10,29,39
2023/3/16 21:20,1,11,1,0,35,42,77
2023/3/16 21:30,1,11,1,0,24,67,91
2023/3/16 21:40,1,11,1,0,20,73,93
2023/3/16 21:50,1,11,1,0,17,82,99
2023/3/16 22:00,1,11,1,0,18,90,108
2023/3/16 22:10,1,10,1,0,14,74,88
2023/3/16 22:20,1,10,1,0,17,46,63
2023/3/16 22:30,1,10,1,0,13,34,47
2023/3/16 22:40,1,10,1,0,12,22,34
2023/3/16 22:50,1,10,1,0,10,15,25
2023/3/16 23:00,1,10,1,0,11,14,25
2023/3/16 23:10,1,10,1,0,6,10,16
2023/3/16 23:20,1,10,1,0,5,8,13
2023/3/16 23:30,1,10,1,0,2,10,12
2023/3/16 23:40,1,10,1,0,2,10,12
2023/3/16 23:50,1,9,1,0,0,5,5
2023/3/17 0:00,1,9,1,0,4,1,5
2023/3/17 0:10,1,9,1,0,3,2,5
2023/3/17 0:20,1,9,1,0,3,2,5
2023/3/17 0:30,1,9,1,0,1,2,3
2023/3/17 0:40,1,9,1,0,3,2,5
2023/3/17 0:50,1,9,1,0,0,2,2
2023/3/17 1:00,1,9,1,0,0,0,0
2023/3/17 1:10,1,9,1,0,0,2,2
2023/3/17 1:20,1,8,1,0,0,1,1
2023/3/17 1:30,1,8,1,0,1,2,3
2023/3/17 1:40,1,8,1,0,1,1,2
2023/3/17 1:50,1,8,1,0,0,0,0
2023/3/17 2:00,1,8,1,0,0,0,0
2023/3/17 2:10,1,7,1,0,1,2,3
2023/3/17 2:20,1,7,1,0,0,1,1
2023/3/17 2:30,1,7,1,0,0,0,0
2023/3/17 2:40,1,7,1,0,1,2,3
2023/3/17 2:50,1,7,1,0,0,2,2
2023/3/17 3:00,1,6,1,0,2,2,4
2023/3/17 3:10,1,6,1,0,2,0,2
2023/3/17 3:20,1,6,1,0,1,0,1
2023/3/17 3:30,1,6,1,0,1,2,3
2023/3/17 3:40,1,6,1,0,2,0,2
2023/3/17 3:50,1,6,1,0,2,1,3
2023/3/17 4:00,1,6,1,0,0,0,0
2023/3/17 4:10,1,6,1,0,2,2,4
2023/3/17 4:20,1,6,1,0,0,1,1
2023/3/17 4:30,1,6,1,0,1,1,2
2023/3/17 4:40,1,6,1,0,1,0,1
2023/3/17 4:50,1,6,1,0,1,1,2
2023/3/17 5:00,1,6,1,0,1,1,2
2023/3/17 5:10,1,6,1,0,2,0,2
2023/3/17 5:20,1,6,1,0,0,2,2
2023/3/17 5:30,1,6,1,0,2,2,4
2023/3/17 5:40,1,6,1,0,0,2,2
2023/3/17 5:50,1,6,1,0,5,1,6
2023/3/17 6:00,1,6,1,0,2,2,4
2023/3/17 6:10,1,6,1,0,2,2,4
2023/3/17 6:20,1,6,1,0,6,3,9
2023/3/17 6:30,1,6,1,0,5,4,9
2023/3/17 6:40,1,6,1,0,13,1,14
2023/3/17 6:50,1,6,1,0,41,1,42
2023/3/17 7:00,1,6,1,0,65,3,68
2023/3/17 7:10,1,6,1,0,95,2,97
2023/3/17 7:20,1,6,1,0,124,3,127
2023/3/17 7:30,1,6,1,0,343,1,344
2023/3/17 7:40,1,6,1,0,544,5,549
2023/3/17 7:50,1,6,1,0,597,5,602
2023/3/17 8:00,1,6,1,0,275,5,280
2023/3/17 8:10,1,6,1,0,131,12,143
2023/3/17 8:20,1,6,1,0,90,11,101
2023/3/17 8:30,1,6,1,0,83,14,97
2023/3/17 8:40,1,6,1,0,78,14,92
2023/3/17 8:50,1,6,1,0,78,10,88
2023/3/17 9:00,1,6,1,0,88,17,105
2023/3/17 9:10,1,6,1,0,78,15,93
2023/3/17 9:20,1,6,1,0,172,29,201
2023/3/17 9:30,1,6,1,0,199,42,241
2023/3/17 9:40,1,6,1,0,250,122,372
2023/3/17 9:50,1,6,1,0,217,191,408
2023/3/17 10:00,1,6,1,0,147,145,292
2023/3/17 10:10,1,6,1,0,86,99,185
2023/3/17 10:20,1,6,1,0,73,64,137
2023/3/17 10:30,1,6,1,0,56,45,101
2023/3/17 10:40,1,6,1,0,58,49,107
2023/3/17 10:50,1,6,1,0,77,39,116
2023/3/17 11:00,1,6,1,0,73,37,110
2023/3/17 11:10,1,6,1,0,65,38,103
2023/3/17 11:20,1,6,1,0,57,45,102
2023/3/17 11:30,1,6,1,0,60,79,139
2023/3/17 11:40,1,7,1,0,75,210,285
2023/3/17 11:50,1,7,1,0,70,295,365
2023/3/17 12:00,1,7,1,0,55,273,328
2023/3/17 12:10,1,7,1,0,59,157,216
2023/3/17 12:20,1,7,1,0,57,123,180
2023/3/17 12:30,1,7,1,0,56,78,134
2023/3/17 12:40,1,7,1,0,57,58,115
2023/3/17 12:50,1,7,1,0,56,49,105
2023/3/17 13:00,1,7,1,0,64,34,98
2023/3/17 13:10,1,7,1,0,67,33,100
2023/3/17 13:20,1,7,1,0,84,30,114
2023/3/17 13:30,1,7,1,0,148,32,180
2023/3/17 13:40,1,7,1,0,228,39,267
2023/3/17 13:50,1,7,1,0,228,40,268
2023/3/17 14:00,1,7,1,0,144,34,178
2023/3/17 14:10,1,7,1,0,119,38,157
2023/3/17 14:20,1,7,1,0,98,39,137
2023/3/17 14:30,1,7,1,0,78,37,115
2023/3/17 14:40,1,7,1,0,70,45,115
2023/3/17 14:50,1,7,1,0,62,41,103
2023/3/17 15:00,1,7,1,0,63,41,104
2023/3/17 15:10,1,7,1,0,66,36,102
2023/3/17 15:20,1,7,1,0,79,45,124
2023/3/17 15:30,1,7,1,0,97,71,168
2023/3/17 15:40,1,7,1,0,136,166,302
2023/3/17 15:50,1,7,1,0,158,239,397
2023/3/17 16:00,1,7,1,0,96,134,230
2023/3/17 16:10,1,7,1,0,89,118,207
2023/3/17 16:20,1,7,1,0,84,81,165
2023/3/17 16:30,1,7,1,0,70,70,140
2023/3/17 16:40,1,7,1,0,76,63,139
2023/3/17 16:50,1,7,1,0,65,65,130
2023/3/17 17:00,1,7,1,0,84,64,148
2023/3/17 17:10,1,7,1,0,76,49,125
2023/3/17 17:20,1,7,1,0,84,63,147
2023/3/17 17:30,1,7,1,0,74,78,152
2023/3/17 17:40,1,7,1,0,80,224,304
2023/3/17 17:50,1,7,1,0,108,276,384
2023/3/17 18:00,1,7,1,0,97,231,328
2023/3/17 18:10,1,7,1,0,85,152,237
2023/3/17 18:20,1,7,1,0,93,101,194
2023/3/17 18:30,1,7,1,0,116,88,204
2023/3/17 18:40,1,7,1,0,172,74,246
2023/3/17 18:50,1,7,1,0,189,66,255
2023/3/17 19:00,1,7,1,0,139,66,205
2023/3/17 19:10,1,7,1,0,130,60,190
2023/3/17 19:20,1,7,1,0,97,58,155
2023/3/17 19:30,1,7,1,0,96,68,164
2023/3/17 19:40,1,7,1,0,93,55,148
2023/3/17 19:50,1,7,1,0,76,70,146
2023/3/17 20:00,1,7,1,0,80,59,139
2023/3/17 20:10,1,7,1,0,72,64,136
2023/3/17 20:20,1,7,1,0,71,71,142
2023/3/17 20:30,1,7,1,0,63,92,155
2023/3/17 20:40,1,7,1,0,67,178,245
2023/3/17 20:50,1,7,1,0,56,272,328
2023/3/17 21:00,1,7,1,0,46,179,225
2023/3/17 21:10,1,7,1,0,48,133,181
2023/3/17 21:20,1,7,1,0,32,100,132
2023/3/17 21:30,1,7,1,0,21,70,91
2023/3/17 21:40,1,7,1,0,18,68,86
2023/3/17 21:50,1,7,1,0,20,90,110
2023/3/17 22:00,1,7,1,0,17,85,102
2023/3/17 22:10,1,7,1,0,15,73,88
2023/3/17 22:20,1,7,1,0,16,50,66
2023/3/17 22:30,1,7,1,0,13,37,50
2023/3/17 22:40,1,7,1,0,11,18,29
2023/3/17 22:50,1,7,1,0,9,13,22
2023/3/17 23:00,1,7,1,0,8,13,21
2023/3/17 23:10,1,7,1,0,7,10,17
2023/3/17 23:20,1,7,1,0,4,10,14
2023/3/17 23:30,1,7,1,0,1,9,10
2023/3/17 23:40,1,7,1,0,1,8,9
2023/3/17 23:50,1,7,1,0,1,4,5
2023/3/18 0:00,1,7,0,0,3,2,5
2023/3/18 0:10,1,7,0,0,1,2,3
2023/3/18 0:20,1,7,0,0,1,2,3
2023/3/18 0:30,1,7,0,0,1,2,3
2023/3/18 0:40,1,7,0,0,0,1,1
2023/3/18 0:50,1,7,0,0,2,2,4
2023/3/18 1:00,1,7,0,0,1,0,1
2023/3/18 1:10,1,7,0,0,0,1,1
2023/3/18 1:20,1,7,0,0,2,2,4
2023/3/18 1:30,1,7,0,0,2,2,4
2023/3/18 1:40,1,7,0,0,1,1,2
2023/3/18 1:50,1,7,0,0,2,0,2
2023/3/18 2:00,1,7,0,0,1,0,1
2023/3/18 2:10,1,7,0,0,0,2,2
2023/3/18 2:20,1,7,0,0,0,1,1
2023/3/18 2:30,1,7,0,0,0,2,2
2023/3/18 2:40,1,7,0,0,0,0,0
2023/3/18 2:50,1,7,0,0,1,0,1
2023/3/18 3:00,1,7,0,0,2,0,2
2023/3/18 3:10,1,7,0,0,0,0,0
2023/3/18 3:20,1,7,0,0,2,2,4
2023/3/18 3:30,1,7,0,0,1,0,1
2023/3/18 3:40,1,7,0,0,0,0,0
2023/3/18 3:50,1,7,0,0,2,1,3
2023/3/18 4:00,1,7,0,0,1,1,2
2023/3/18 4:10,1,7,0,0,0,0,0
2023/3/18 4:20,1,7,0,0,2,2,4
2023/3/18 4:30,1,7,0,0,2,0,2
2023/3/18 4:40,1,7,0,0,0,1,1
2023/3/18 4:50,1,7,0,0,1,0,1
2023/3/18 5:00,1,7,0,0,0,2,2
2023/3/18 5:10,1,7,0,0,2,2,4
2023/3/18 5:20,1,7,0,0,2,1,3
2023/3/18 5:30,1,7,0,0,2,1,3
2023/3/18 5:40,1,7,0,0,1,1,2
2023/3/18 5:50,1,7,0,0,3,2,5
2023/3/18 6:00,1,7,0,0,7,2,9
2023/3/18 6:10,1,7,0,0,6,2,8
2023/3/18 6:20,1,7,0,0,5,0,5
2023/3/18 6:30,1,7,0,0,11,2,13
2023/3/18 6:40,1,7,0,0,9,0,9
2023/3/18 6:50,1,7,0,0,9,3,12
2023/3/18 7:00,1,7,0,0,16,1,17
2023/3/18 7:10,1,7,0,0,20,1,21
2023/3/18 7:20,1,7,0,0,41,3,44
2023/3/18 7:30,1,7,0,0,49,3,52
2023/3/18 7:40,1,7,0,0,66,3,69
2023/3/18 7:50,1,7,0,0,55,3,58
2023/3/18 8:00,1,7,0,0,45,6,51
2023/3/18 8:10,1,7,0,0,37,4,41
2023/3/18 8:20,1,7,0,0,27,1,28
2023/3/18 8:30,1,7,0,0,34,2,36
2023/3/18 8:40,1,7,0,0,25,4,29
2023/3/18 8:50,1,8,0,0,34,3,37
2023/3/18 9:00,1,8,0,0,35,3,38
2023/3/18 9:10,1,8,0,0,31,7,38
2023/3/18 9:20,1,8,0,0,29,8,37
2023/3/18 9:30,1,8,0,0,38,15,53
2023/3/18 9:40,1,8,0,0,43,14,57
2023/3/18 9:50,1,8,0,0,43,12,55
2023/3/18 10:00,1,8,0,0,30,18,48
2023/3/18 10:10,1,8,0,0,22,13,35
2023/3/18 10:20,1,8,0,0,20,10,30
2023/3/18 10:30,1,8,0,0,21,13,34
2023/3/18 10:40,1,8,0,0,19,15,34
2023/3/18 10:50,1,8,0,0,21,19,40
2023/3/18 11:00,1,8,0,0,15,21,36
2023/3/18 11:10,1,8,0,0,19,16,35
2023/3/18 11:20,1,8,0,0,14,21,35
2023/3/18 11:30,1,8,0,0,16,24,40
2023/3/18 11:40,1,8,0,0,11,25,36
2023/3/18 11:50,1,8,0,0,10,29,39
2023/3/18 12:00,1,8,0,0,11,34,45
2023/3/18 12:10,1,8,0,0,12,30,42
2023/3/18 12:20,1,8,0,0,14,28,42
2023/3/18 12:30,1,8,0,0,16,33,49
2023/3/18 12:40,1,8,0,0,14,32,46
2023/3/18 12:50,1,8,0,0,9,30,39
2023/3/18 13:00,1,8,0,0,10,21,31
2023/3/18 13:10,1,8,0,0,13,19,32
2023/3/18 13:20,1,8,0,0,17,16,33
2023/3/18 13:30,1,8,0,0,15,16,31
2023/3/18 13:40,1,8,0,0,28,18,46
2023/3/18 13:50,1,8,0,0,22,18,40
2023/3/18 14:00,1,9,0,0,22,16,38
2023/3/18 14:10,1,9,0,0,20,23,43
2023/3/18 14:20,1,9,0,0,14,16,30
2023/3/18 14:30,1,9,0,0,15,15,30
2023/3/18 14:40,1,9,0,0,15,16,31
2023/3/18 14:50,1,9,0,0,20,15,35
2023/3/18 15:00,1,9,0,0,23,13,36
2023/3/18 15:10,1,9,0,0,22,13,35
2023/3/18 15:20,1,9,0,0,22,15,37
2023/3/18 15:30,1,9,0,0,29,16,45
2023/3/18 15:40,1,9,0,0,23,16,39
2023/3/18 15:50,1,9,0,0,30,17,47
2023/3/18 16:00,1,9,0,0,25,16,41
2023/3/18 16:10,1,9,0,0,26,17,43
2023/3/18 16:20,1,9,0,0,25,12,37
2023/3/18 16:30,1,9,0,0,30,11,41
2023/3/18 16:40,1,9,0,0,25,12,37
2023/3/18 16:50,1,9,0,0,32,15,47
2023/3/18 17:00,1,9,0,0,32,17,49
2023/3/18 17:10,1,9,0,0,36,21,57
2023/3/18 17:20,1,9,0,0,33,23,56
2023/3/18 17:30,1,9,0,0,35,23,58
2023/3/18 17:40,1,9,0,0,33,27,60
2023/3/18 17:50,1,9,0,0,32,30,62
2023/3/18 18:00,1,9,0,0,42,35,77
2023/3/18 18:10,1,9,0,0,39,30,69
2023/3/18 18:20,1,9,0,0,38,29,67
2023/3/18 18:30,1,9,0,0,42,29,71
2023/3/18 18:40,1,9,0,0,44,24,68
2023/3/18 18:50,1,9,0,0,42,31,73
2023/3/18 19:00,1,9,0,0,32,20,52
2023/3/18 19:10,1,9,0,0,32,23,55
2023/3/18 19:20,1,9,0,0,26,21,47
2023/3/18 19:30,1,9,0,0,21,21,42
2023/3/18 19:40,1,9,0,0,26,22,48
2023/3/18 19:50,1,9,0,0,19,16,35
2023/3/18 20:00,1,9,0,0,22,23,45
2023/3/18 20:10,1,9,0,0,17,20,37
2023/3/18 20:20,1,9,0,0,15,24,39
2023/3/18 20:30,1,9,0,0,16,29,45
2023/3/18 20:40,1,9,0,0,17,31,48
2023/3/18 20:50,1,9,0,0,15,30,45
2023/3/18 21:00,1,9,0,0,11,37,48
2023/3/18 21:10,1,9,0,0,14,29,43
2023/3/18 21:20,1,9,0,0,12,25,37
2023/3/18 21:30,1,9,0,0,12,22,34
2023/3/18 21:40,1,9,0,0,7,43,50
2023/3/18 21:50,1,9,0,0,8,46,54
2023/3/18 22:00,1,9,0,0,4,35,39
2023/3/18 22:10,1,9,0,0,4,32,36
2023/3/18 22:20,1,9,0,0,2,28,30
2023/3/18 22:30,1,9,0,0,1,15,16
2023/3/18 22:40,1,9,0,0,3,10,13
2023/3/18 22:50,1,9,0,0,2,10,12
2023/3/18 23:00,1,9,0,0,3,4,7
2023/3/18 23:10,1,9,0,0,1,6,7
2023/3/18 23:20,1,9,0,0,0,1,1
2023/3/18 23:30,1,9,0,0,2,1,3
2023/3/18 23:40,1,9,0,0,1,2,3
2023/3/18 23:50,1,9,0,0,1,0,1
2023/3/19 0:00,1,9,0,0,2,2,4
2023/3/19 0:10,1,8,0,0,0,0,0
2023/3/19 0:20,1,8,0,0,1,2,3
2023/3/19 0:30,1,8,0,0,1,2,3
2023/3/19 0:40,1,8,0,0,0,0,0
2023/3/19 0:50,1,8,0,0,2,0,2
2023/3/19 1:00,1,8,0,0,0,2,2
2023/3/19 1:10,1,8,0,0,1,1,2
2023/3/19 1:20,1,8,0,0,1,0,1
2023/3/19 1:30,1,8,0,0,0,0,0
2023/3/19 1:40,1,8,0,0,0,1,1
2023/3/19 1:50,1,8,0,0,0,0,0
2023/3/19 2:00,1,8,0,0,1,2,3
2023/3/19 2:10,1,8,0,0,2,2,4
2023/3/19 2:20,1,8,0,0,1,2,3
2023/3/19 2:30,1,8,0,0,0,1,1
2023/3/19 2:40,1,8,0,0,1,0,1
2023/3/19 2:50,1,8,0,0,0,0,0
2023/3/19 3:00,1,8,0,0,1,1,2
2023/3/19 3:10,1,8,0,0,2,2,4
2023/3/19 3:20,1,8,0,0,1,0,1
2023/3/19 3:30,1,8,0,0,1,0,1
2023/3/19 3:40,1,8,0,0,0,0,0
2023/3/19 3:50,1,8,0,0,0,1,1
2023/3/19 4:00,1,8,0,0,1,1,2
2023/3/19 4:10,1,8,0,0,0,0,0
2023/3/19 4:20,1,8,0,0,0,0,0
2023/3/19 4:30,0,8,0,0,0,0,0
2023/3/19 4:40,0,8,0,0,0,0,0
2023/3/19 4:50,0,8,0,0,0,0,0
2023/3/19 5:00,0,8,0,0,0,0,0
2023/3/19 5:10,0,8,0,0,0,0,0
2023/3/19 5:20,0,8,0,0,1,0,1
2023/3/19 5:30,0,8,0,0,0,0,0
2023/3/19 5:40,0,8,0,0,0,0,0
2023/3/19 5:50,0,8,0,0,0,0,0
2023/3/19 6:00,0,8,0,0,1,0,1
2023/3/19 6:10,0,8,0,0,2,0,2
2023/3/19 6:20,0,8,0,0,2,0,2
2023/3/19 6:30,0,8,0,0,2,1,3
2023/3/19 6:40,0,8,0,0,2,0,2
2023/3/19 6:50,0,8,0,0,2,1,3
2023/3/19 7:00,0,8,0,0,3,0,3
2023/3/19 7:10,0,8,0,0,5,1,6
2023/3/19 7:20,0,8,0,0,8,1,9
2023/3/19 7:30,0,8,0,0,11,1,12
2023/3/19 7:40,0,8,0,0,12,1,13
2023/3/19 7:50,0,8,0,0,10,1,11
2023/3/19 8:00,0,8,0,0,9,1,10
2023/3/19 8:10,0,8,0,0,9,1,10
2023/3/19 8:20,0,8,0,0,7,0,7
2023/3/19 8:30,0,8,0,0,7,0,7
2023/3/19 8:40,0,8,0,0,6,1,7
2023/3/19 8:50,0,8,0,0,6,1,7
2023/3/19 9:00,0,8,0,0,6,0,6
2023/3/19 9:10,0,8,0,0,7,1,8
2023/3/19 9:20,0,8,0,0,6,1,7
2023/3/19 9:30,0,8,0,0,7,3,10
2023/3/19 9:40,0,8,0,0,8,3,11
2023/3/19 9:50,0,8,0,0,9,2,11
2023/3/19 10:00,0,8,0,0,7,4,11
2023/3/19 10:10,0,8,0,0,5,2,7
2023/3/19 10:20,0,8,0,0,4,2,6
2023/3/19 10:30,0,8,0,0,4,2,6
2023/3/19 10:40,0,8,0,0,4,3,7
2023/3/19 10:50,0,8,0,0,3,3,6
2023/3/19 11:00,0,8,0,0,3,4,7
2023/3/19 11:10,0,8,0,0,4,4,8
2023/3/19 11:20,0,8,0,0,2,4,6
2023/3/19 11:30,0,8,0,0,3,4,7
2023/3/19 11:40,0,8,0,0,2,5,7
2023/3/19 11:50,0,8,0,0,2,6,8
2023/3/19 12:00,0,8,0,0,2,7,9
2023/3/19 12:10,0,8,0,0,3,5,8
2023/3/19 12:20,0,8,0,0,2,6,8
2023/3/19 12:30,0,8,0,0,3,6,9
2023/3/19 12:40,0,8,0,0,3,6,9
2023/3/19 12:50,0,8,0,0,2,5,7
2023/3/19 13:00,0,8,0,0,2,5,7
2023/3/19 13:10,0,8,0,0,2,4,6
2023/3/19 13:20,0,8,0,0,3,3,6
2023/3/19 13:30,0,8,0,0,3,3,6
2023/3/19 13:40,0,8,0,0,5,4,9
2023/3/19 13:50,0,8,0,0,5,4,9
2023/3/19 14:00,0,8,0,0,4,3,7
2023/3/19 14:10,0,8,0,0,4,4,8
2023/3/19 14:20,0,8,0,0,3,3,6
2023/3/19 14:30,0,8,0,0,3,4,7
2023/3/19 14:40,0,8,0,0,3,3,6
2023/3/19 14:50,0,9,0,0,3,3,6
2023/3/19 15:00,0,9,0,0,4,2,6
2023/3/19 15:10,0,9,0,0,5,3,8
2023/3/19 15:20,0,9,0,0,4,3,7
2023/3/19 15:30,0,9,0,0,5,3,8
2023/3/19 15:40,0,9,0,0,4,4,8
2023/3/19 15:50,0,9,0,0,6,3,9
2023/3/19 16:00,0,9,0,0,5,3,8
2023/3/19 16:10,0,9,0,0,5,3,8
2023/3/19 16:20,0,9,0,0,5,2,7
2023/3/19 16:30,0,9,0,0,6,2,8
2023/3/19 16:40,0,9,0,0,6,2,8
2023/3/19 16:50,0,9,0,0,7,3,10
2023/3/19 17:00,0,9,0,0,6,3,9
2023/3/19 17:10,0,9,0,0,7,4,11
2023/3/19 17:20,0,9,0,0,7,5,12
2023/3/19 17:30,0,9,0,0,8,5,13
2023/3/19 17:40,0,9,0,0,7,7,14
2023/3/19 17:50,0,9,0,0,7,6,13
2023/3/19 18:00,0,9,0,0,9,6,15
2023/3/19 18:10,0,9,0,0,8,7,15
2023/3/19 18:20,0,9,0,0,10,6,16
2023/3/19 18:30,1,9,0,0,29,14,43
2023/3/19 18:40,1,9,0,0,35,25,60
2023/3/19 18:50,1,9,0,0,39,27,66
2023/3/19 19:00,1,9,0,0,30,22,52
2023/3/19 19:10,1,9,0,0,25,20,45
2023/3/19 19:20,1,9,0,0,22,19,41
2023/3/19 19:30,1,9,0,0,26,20,46
2023/3/19 19:40,1,9,0,0,29,21,50
2023/3/19 19:50,1,9,0,0,22,16,38
2023/3/19 20:00,1,9,0,0,23,23,46
2023/3/19 20:10,1,9,0,0,15,20,35
2023/3/19 20:20,1,9,0,0,16,25,41
2023/3/19 20:30,1,9,0,0,14,31,45
2023/3/19 20:40,1,9,0,0,14,29,43
2023/3/19 20:50,1,9,0,0,17,33,50
2023/3/19 21:00,1,9,0,0,12,34,46
2023/3/19 21:10,1,9,0,0,16,26,42
2023/3/19 21:20,1,9,0,0,10,21,31
2023/3/19 21:30,1,9,0,0,10,25,35
2023/3/19 21:40,1,9,0,0,6,39,45
2023/3/19 21:50,1,9,0,0,9,38,47
2023/3/19 22:00,1,9,0,0,7,36,43
2023/3/19 22:10,1,9,0,0,4,30,34
2023/3/19 22:20,1,9,0,0,4,30,34
2023/3/19 22:30,1,9,0,0,1,16,17
2023/3/19 22:40,1,9,0,0,3,12,15
2023/3/19 22:50,1,9,0,0,2,11,13
2023/3/19 23:00,1,9,0,0,1,6,7
2023/3/19 23:10,1,9,0,0,2,6,8
2023/3/19 23:20,1,9,0,0,2,2,4
2023/3/19 23:30,1,9,0,0,0,2,2
2023/3/19 23:40,1,9,0,0,2,2,4
2023/3/19 23:50,1,9,0,0,1,2,3
2023/3/20 0:00,1,9,1,0,5,0,5
2023/3/20 0:10,1,9,1,0,2,0,2
2023/3/20 0:20,1,9,1,0,2,2,4
2023/3/20 0:30,1,9,1,0,2,2,4
2023/3/20 0:40,1,9,1,0,1,0,1
2023/3/20 0:50,1,9,1,0,1,2,3
2023/3/20 1:00,1,9,1,0,2,1,3
2023/3/20 1:10,1,9,1,0,0,1,1
2023/3/20 1:20,1,9,1,0,0,0,0
2023/3/20 1:30,1,9,1,0,2,0,2
2023/3/20 1:40,1,9,1,0,2,1,3
2023/3/20 1:50,1,9,1,0,0,1,1
2023/3/20 2:00,1,9,1,0,1,1,2
2023/3/20 2:10,1,9,1,0,2,0,2
2023/3/20 2:20,1,9,1,0,1,1,2
2023/3/20 2:30,1,9,1,0,1,1,2
2023/3/20 2:40,1,9,1,0,1,2,3
2023/3/20 2:50,1,9,1,0,2,2,4
2023/3/20 3:00,1,9,1,0,2,1,3
2023/3/20 3:10,1,9,1,0,2,1,3
2023/3/20 3:20,1,9,1,0,0,2,2
2023/3/20 3:30,1,9,1,0,2,1,3
2023/3/20 3:40,1,9,1,0,2,1,3
2023/3/20 3:50,1,9,1,0,0,1,1
2023/3/20 4:00,1,10,1,0,1,0,1
2023/3/20 4:10,1,10,1,0,0,2,2
2023/3/20 4:20,1,10,1,0,0,0,0
2023/3/20 4:30,1,10,1,0,0,2,2
2023/3/20 4:40,1,10,1,0,2,0,2
2023/3/20 4:50,1,10,1,0,0,0,0
2023/3/20 5:00,1,10,1,0,2,0,2
2023/3/20 5:10,1,10,1,0,2,0,2
2023/3/20 5:20,1,10,1,0,0,1,1
2023/3/20 5:30,1,10,1,0,1,0,1
2023/3/20 5:40,1,10,1,0,1,1,2
2023/3/20 5:50,1,10,1,0,3,2,5
2023/3/20 6:00,1,10,1,0,2,2,4
2023/3/20 6:10,1,10,1,0,2,2,4
2023/3/20 6:20,1,10,1,0,6,3,9
2023/3/20 6:30,1,10,1,0,5,4,9
2023/3/20 6:40,1,10,1,0,11,1,12
2023/3/20 6:50,1,10,1,0,35,2,37
2023/3/20 7:00,1,10,1,0,55,2,57
2023/3/20 7:10,1,10,1,0,95,2,97
2023/3/20 7:20,1,10,1,0,107,2,109
2023/3/20 7:30,1,10,1,0,288,1,289
2023/3/20 7:40,1,10,1,0,555,4,559
2023/3/20 7:50,1,11,1,0,638,6,644
2023/3/20 8:00,1,11,1,0,317,8,325
2023/3/20 8:10,1,11,1,0,138,8,146
2023/3/20 8:20,1,11,1,0,96,9,105
2023/3/20 8:30,1,11,1,0,81,14,95
2023/3/20 8:40,1,11,1,0,73,14,87
2023/3/20 8:50,1,11,1,0,80,14,94
2023/3/20 9:00,1,11,1,0,91,15,106
2023/3/20 9:10,1,11,1,0,87,18,105
2023/3/20 9:20,1,11,1,0,167,28,195
2023/3/20 9:30,1,11,1,0,238,40,278
2023/3/20 9:40,1,11,1,0,253,146,399
2023/3/20 9:50,1,11,1,0,189,185,374
2023/3/20 10:00,1,11,1,0,142,144,286
2023/3/20 10:10,1,11,1,0,76,100,176
2023/3/20 10:20,1,11,1,0,83,66,149
2023/3/20 10:30,1,11,1,0,62,47,109
2023/3/20 10:40,1,11,1,0,61,40,101
2023/3/20 10:50,1,11,1,0,71,41,112
2023/3/20 11:00,1,11,1,0,60,38,98
2023/3/20 11:10,1,11,1,0,63,41,104
2023/3/20 11:20,1,11,1,0,55,50,105
2023/3/20 11:30,1,11,1,0,62,63,125
2023/3/20 11:40,1,11,1,0,78,219,297
2023/3/20 11:50,1,11,1,0,69,305,374
2023/3/20 12:00,1,11,1,0,63,236,299
2023/3/20 12:10,1,11,1,0,50,168,218
2023/3/20 12:20,1,11,1,0,64,129,193
2023/3/20 12:30,1,11,1,0,57,84,141
2023/3/20 12:40,1,11,1,0,60,74,134
2023/3/20 12:50,1,11,1,0,66,46,112
2023/3/20 13:00,1,11,1,0,57,26,83
2023/3/20 13:10,1,11,1,0,68,35,103
2023/3/20 13:20,1,11,1,0,82,31,113
2023/3/20 13:30,1,11,1,0,169,37,206
2023/3/20 13:40,1,11,1,0,231,34,265
2023/3/20 13:50,1,11,1,0,219,42,261
2023/3/20 14:00,1,11,1,0,117,30,147
2023/3/20 14:10,1,11,1,0,106,41,147
2023/3/20 14:20,1,11,1,0,108,41,149
2023/3/20 14:30,1,11,1,0,98,44,142
2023/3/20 14:40,1,11,1,0,71,46,117
2023/3/20 14:50,1,11,1,0,71,42,113
2023/3/20 15:00,1,11,1,0,76,40,116
2023/3/20 15:10,1,11,1,0,67,38,105
2023/3/20 15:20,1,11,1,0,77,39,116
2023/3/20 15:30,1,11,1,0,88,69,157
2023/3/20 15:40,1,11,1,0,124,153,277
2023/3/20 15:50,1,11,1,0,158,213,371
2023/3/20 16:00,1,11,1,0,96,151,247
2023/3/20 16:10,1,11,1,0,83,113,196
2023/3/20 16:20,1,11,1,0,76,70,146
2023/3/20 16:30,1,11,1,0,68,69,137
2023/3/20 16:40,1,11,1,0,64,58,122
2023/3/20 16:50,1,11,1,0,80,68,148
2023/3/20 17:00,1,11,1,0,71,63,134
2023/3/20 17:10,1,11,1,0,77,62,139
2023/3/20 17:20,1,11,1,0,82,61,143
2023/3/20 17:30,1,11,1,0,83,80,163
2023/3/20 17:40,1,11,1,0,86,232,318
2023/3/20 17:50,1,11,1,0,95,225,320
2023/3/20 18:00,1,11,1,0,95,200,295
2023/3/20 18:10,1,11,1,0,83,150,233
2023/3/20 18:20,1,11,1,0,103,103,206
2023/3/20 18:30,1,11,1,0,114,80,194
2023/3/20 18:40,1,11,1,0,198,75,273
2023/3/20 18:50,1,10,1,0,186,62,248
2023/3/20 19:00,1,10,1,0,128,68,196
2023/3/20 19:10,1,10,1,0,128,64,192
2023/3/20 19:20,1,10,1,0,103,56,159
2023/3/20 19:30,1,10,1,0,99,62,161
2023/3/20 19:40,1,10,1,0,84,51,135
2023/3/20 19:50,1,10,1,0,85,69,154
2023/3/20 20:00,1,10,1,0,79,62,141
2023/3/20 20:10,1,10,1,0,85,70,155
2023/3/20 20:20,1,10,1,0,74,70,144
2023/3/20 20:30,1,10,1,0,64,106,170
2023/3/20 20:40,1,10,1,0,68,214,282
2023/3/20 20:50,1,10,1,0,51,244,295
2023/3/20 21:00,1,10,1,0,52,175,227
2023/3/20 21:10,1,10,1,0,51,118,169
2023/3/20 21:20,1,10,1,0,28,98,126
2023/3/20 21:30,1,10,1,0,25,75,100
2023/3/20 21:40,1,10,1,0,20,66,86
2023/3/20 21:50,1,10,1,0,15,74,89
2023/3/20 22:00,1,10,1,0,16,79,95
2023/3/20 22:10,1,10,1,0,14,80,94
2023/3/20 22:20,1,10,1,0,15,42,57
2023/3/20 22:30,1,10,1,0,14,31,45
2023/3/20 22:40,1,10,1,0,11,18,29
2023/3/20 22:50,1,10,1,0,10,14,24
2023/3/20 23:00,1,10,1,0,11,12,23
2023/3/20 23:10,1,10,1,0,5,11,16
2023/3/20 23:20,1,10,1,0,6,12,18
2023/3/20 23:30,1,10,1,0,1,9,10
2023/3/20 23:40,1,10,1,0,2,10,12
2023/3/20 23:50,1,9,1,0,0,3,3
2023/3/21 0:00,1,9,1,0,3,0,3
2023/3/21 0:10,1,9,1,0,3,2,5
2023/3/21 0:20,1,9,1,0,2,1,3
2023/3/21 0:30,1,9,1,0,2,0,2
2023/3/21 0:40,1,9,1,0,2,1,3
2023/3/21 0:50,1,9,1,0,1,2,3
2023/3/21 1:00,1,9,1,0,2,1,3
2023/3/21 1:10,1,9,1,0,0,2,2
2023/3/21 1:20,1,9,1,0,1,1,2
2023/3/21 1:30,1,9,1,0,0,0,0
2023/3/21 1:40,1,9,1,0,1,0,1
2023/3/21 1:50,1,9,1,0,0,0,0
2023/3/21 2:00,1,9,1,0,0,1,1
2023/3/21 2:10,1,9,1,0,1,1,2
2023/3/21 2:20,1,9,1,0,1,2,3
2023/3/21 2:30,1,9,1,0,1,0,1
2023/3/21 2:40,1,9,1,0,0,2,2
2023/3/21 2:50,1,9,1,0,1,0,1
2023/3/21 3:00,1,9,1,0,1,0,1
2023/3/21 3:10,1,9,1,0,2,1,3
2023/3/21 3:20,1,9,1,0,2,2,4
2023/3/21 3:30,1,9,1,0,1,0,1
2023/3/21 3:40,1,9,1,0,0,1,1
2023/3/21 3:50,1,9,1,0,0,0,0
2023/3/21 4:00,1,9,1,0,0,1,1
2023/3/21 4:10,1,9,1,0,2,1,3
2023/3/21 4:20,1,9,1,0,0,2,2
2023/3/21 4:30,1,9,1,0,2,1,3
2023/3/21 4:40,1,9,1,0,0,2,2
2023/3/21 4:50,1,9,1,0,0,0,0
2023/3/21 5:00,1,9,1,0,0,0,0
2023/3/21 5:10,1,9,1,0,0,0,0
2023/3/21 5:20,1,9,1,0,2,0,2
2023/3/21 5:30,1,9,1,0,2,1,3
2023/3/21 5:40,1,9,1,0,1,1,2
2023/3/21 5:50,1,9,1,0,3,0,3
2023/3/21 6:00,1,9,1,0,2,3,5
2023/3/21 6:10,1,9,1,0,3,1,4
2023/3/21 6:20,1,9,1,0,5,1,6
2023/3/21 6:30,1,9,1,0,5,4,9
2023/3/21 6:40,1,9,1,0,11,0,11
2023/3/21 6:50,1,9,1,0,36,1,37
2023/3/21 7:00,1,9,1,0,60,3,63
2023/3/21 7:10,1,9,1,0,100,2,102
2023/3/21 7:20,1,9,1,0,98,3,101
2023/3/21 7:30,1,9,1,0,345,2,347
2023/3/21 7:40,1,10,1,0,541,4,545
2023/3/21 7:50,1,10,1,0,544,4,548
2023/3/21 8:00,1,10,1,0,292,8,300
2023/3/21 8:10,1,10,1,0,133,8,141
2023/3/21 8:20,1,10,1,0,84,9,93
2023/3/21 8:30,1,10,1,0,91,12,103
2023/3/21 8:40,1,10,1,0,81,15,96
2023/3/21 8:50,1,10,1,0,69,14,83
2023/3/21 9:00,1,10,1,0,72,15,87
2023/3/21 9:10,1,10,1,0,91,20,111
2023/3/21 9:20,1,10,1,0,148,31,179
2023/3/21 9:30,1,10,1,0,205,38,243
2023/3/21 9:40,1,10,1,0,239,133,372
2023/3/21 9:50,1,10,1,0,204,196,400
2023/3/21 10:00,1,10,1,0,141,160,301
2023/3/21 10:10,1,10,1,0,71,88,159
2023/3/21 10:20,1,10,1,0,81,75,156
2023/3/21 10:30,1,11,1,0,67,49,116
2023/3/21 10:40,1,11,1,0,69,46,115
2023/3/21 10:50,1,11,1,0,73,41,114
2023/3/21 11:00,1,11,1,0,66,34,100
2023/3/21 11:10,1,11,1,0,54,37,91
2023/3/21 11:20,1,11,1,0,53,41,94
2023/3/21 11:30,1,11,1,0,60,77,137
2023/3/21 11:40,1,11,1,0,72,205,277
2023/3/21 11:50,1,11,1,0,69,287,356
2023/3/21 12:00,1,11,1,0,60,273,333
2023/3/21 12:10,1,11,1,0,60,183,243
2023/3/21 12:20,1,11,1,0,63,118,181
2023/3/21 12:30,1,11,1,0,57,96,153
2023/3/21 12:40,1,11,1,0,61,71,132
2023/3/21 12:50,1,11,1,0,58,49,107
2023/3/21 13:00,1,11,1,0,54,29,83
2023/3/21 13:10,1,11,1,0,64,37,101
2023/3/21 13:20,1,11,1,0,89,33,122
2023/3/21 13:30,1,11,1,0,145,32,177
2023/3/21 13:40,1,11,1,0,240,37,277
2023/3/21 13:50,1,11,1,0,260,38,298
2023/3/21 14:00,1,11,1,0,117,33,150
2023/3/21 14:10,1,11,1,0,111,39,150
2023/3/21 14:20,1,11,1,0,90,39,129
2023/3/21 14:30,1,11,1,0,87,45,132
2023/3/21 14:40,1,12,1,0,79,43,122
2023/3/21 14:50,1,12,1,0,76,40,116
2023/3/21 15:00,1,12,1,0,74,48,122
2023/3/21 15:10,1,12,1,0,66,44,110
2023/3/21 15:20,1,12,1,0,82,38,120
2023/3/21 15:30,1,12,1,0,94,58,152
2023/3/21 15:40,1,12,1,0,137,168,305
2023/3/21 15:50,1,12,1,0,164,231,395
2023/3/21 16:00,1,12,1,0,105,162,267
2023/3/21 16:10,1,12,1,0,77,118,195
2023/3/21 16:20,1,12,1,0,75,70,145
2023/3/21 16:30,1,12,1,0,80,73,153
2023/3/21 16:40,1,12,1,0,69,59,128
2023/3/21 16:50,1,13,1,0,73,61,134
2023/3/21 17:00,1,13,1,0,68,56,124
2023/3/21 17:10,1,13,1,0,69,58,127
2023/3/21 17:20,1,13,1,0,81,57,138
2023/3/21 17:30,1,13,1,0,82,74,156
2023/3/21 17:40,1,13,1,0,88,265,353
2023/3/21 17:50,1,13,1,0,87,245,332
2023/3/21 18:00,1,13,1,0,103,186,289
2023/3/21 18:10,1,13,1,0,77,158,235
2023/3/21 18:20,1,13,1,0,88,109,197
2023/3/21 18:30,1,13,1,0,118,88,206
2023/3/21 18:40,1,13,1,0,158,80,238
2023/3/21 18:50,1,13,1,0,153,73,226
2023/3/21 19:00,1,13,1,0,118,60,178
2023/3/21 19:10,1,13,1,0,111,64,175
2023/3/21 19:20,1,13,1,0,111,57,168
2023/3/21 19:30,1,13,1,0,97,53,150
2023/3/21 19:40,1,13,1,0,101,51,152
2023/3/21 19:50,1,13,1,0,95,63,158
2023/3/21 20:00,1,13,1,0,74,66,140
2023/3/21 20:10,1,13,1,0,71,64,135
2023/3/21 20:20,1,13,1,0,75,59,134
2023/3/21 20:30,1,13,1,0,65,96,161
2023/3/21 20:40,1,13,1,0,73,218,291
2023/3/21 20:50,1,13,1,0,50,230,280
2023/3/21 21:00,1,13,1,0,47,171,218
2023/3/21 21:10,1,13,1,0,56,147,203
2023/3/21 21:20,1,13,1,0,32,107,139
2023/3/21 21:30,1,13,1,0,22,69,91
2023/3/21 21:40,1,13,1,0,19,77,96
2023/3/21 21:50,1,13,1,0,19,89,108
2023/3/21 22:00,1,12,1,0,17,88,105
2023/3/21 22:10,1,12,1,0,15,65,80
2023/3/21 22:20,1,12,1,0,17,42,59
2023/3/21 22:30,1,12,1,0,13,38,51
2023/3/21 22:40,1,12,1,0,10,21,31
2023/3/21 22:50,1,12,1,0,9,14,23
2023/3/21 23:00,1,12,1,0,9,10,19
2023/3/21 23:10,1,12,1,0,7,12,19
2023/3/21 23:20,1,12,1,0,7,10,17
2023/3/21 23:30,1,12,1,0,2,9,11
2023/3/21 23:40,1,12,1,0,2,9,11
2023/3/21 23:50,1,12,1,0,1,5,6
2023/3/22 0:00,1,12,1,0,5,1,6
2023/3/22 0:10,1,12,1,0,2,0,2
2023/3/22 0:20,1,12,1,0,3,2,5
2023/3/22 0:30,1,12,1,0,2,0,2
2023/3/22 0:40,1,12,1,0,2,2,4
2023/3/22 0:50,1,12,1,0,0,2,2
2023/3/22 1:00,1,12,1,0,1,1,2
2023/3/22 1:10,1,11,1,0,1,1,2
2023/3/22 1:20,1,11,1,0,1,1,2
2023/3/22 1:30,1,11,1,0,0,0,0
2023/3/22 1:40,1,11,1,0,0,0,0
2023/3/22 1:50,1,11,1,0,1,2,3
2023/3/22 2:00,1,11,1,0,0,0,0
2023/3/22 2:10,1,11,1,0,0,1,1
2023/3/22 2:20,1,11,1,0,1,0,1
2023/3/22 2:30,1,11,1,0,2,2,4
2023/3/22 2:40,1,11,1,0,0,0,0
2023/3/22 2:50,1,11,1,0,1,1,2
2023/3/22 3:00,1,11,1,0,2,0,2
2023/3/22 3:10,1,11,1,0,2,0,2
2023/3/22 3:20,1,11,1,0,2,0,2
2023/3/22 3:30,1,11,1,0,1,1,2
2023/3/22 3:40,1,11,1,0,1,0,1
2023/3/22 3:50,1,11,1,0,2,1,3
2023/3/22 4:00,1,11,1,0,1,0,1
2023/3/22 4:10,1,11,1,0,2,1,3
2023/3/22 4:20,1,11,1,0,1,0,1
2023/3/22 4:30,1,11,1,0,0,0,0
2023/3/22 4:40,1,11,1,0,2,2,4
2023/3/22 4:50,1,11,1,0,1,2,3
2023/3/22 5:00,1,11,1,0,2,2,4
2023/3/22 5:10,1,11,1,0,1,1,2
2023/3/22 5:20,1,11,1,0,1,1,2
2023/3/22 5:30,1,11,1,0,1,1,2
2023/3/22 5:40,1,11,1,0,0,1,1
2023/3/22 5:50,1,11,1,0,4,0,4
2023/3/22 6:00,1,11,1,0,3,2,5
2023/3/22 6:10,1,11,1,0,2,3,5
2023/3/22 6:20,1,11,1,0,6,2,8
2023/3/22 6:30,1,11,1,0,6,2,8
2023/3/22 6:40,1,11,1,0,10,1,11
2023/3/22 6:50,1,11,1,0,42,2,44
2023/3/22 7:00,1,12,1,0,67,3,70
2023/3/22 7:10,1,12,1,0,97,1,98
2023/3/22 7:20,1,12,1,0,121,1,122
2023/3/22 7:30,1,12,1,0,337,1,338
2023/3/22 7:40,1,12,1,0,552,5,557
2023/3/22 7:50,1,12,1,0,597,3,600
2023/3/22 8:00,1,12,1,0,301,7,308
2023/3/22 8:10,1,12,1,0,148,12,160
2023/3/22 8:20,1,12,1,0,89,8,97
2023/3/22 8:30,1,12,1,0,82,13,95
2023/3/22 8:40,1,12,1,0,71,14,85
2023/3/22 8:50,1,12,1,0,81,10,91
2023/3/22 9:00,1,12,1,0,74,17,91
2023/3/22 9:10,1,12,1,0,86,19,105
2023/3/22 9:20,1,12,1,0,159,30,189
2023/3/22 9:30,1,12,1,0,231,38,269
2023/3/22 9:40,1,13,1,0,266,114,380
2023/3/22 9:50,1,13,1,0,173,157,330
2023/3/22 10:00,1,13,1,0,119,142,261
2023/3/22 10:10,1,13,1,0,89,103,192
2023/3/22 10:20,1,13,1,0,80,70,150
2023/3/22 10:30,1,13,1,0,65,53,118
2023/3/22 10:40,1,13,1,0,61,49,110
2023/3/22 10:50,1,13,1,0,70,41,111
2023/3/22 11:00,1,13,1,0,70,38,108
2023/3/22 11:10,1,13,1,0,66,34,100
2023/3/22 11:20,1,13,1,0,54,39,93
2023/3/22 11:30,1,13,1,0,78,63,141
2023/3/22 11:40,1,14,1,0,66,216,282
2023/3/22 11:50,1,14,1,0,59,279,338
2023/3/22 12:00,1,14,1,0,58,252,310
2023/3/22 12:10,1,14,1,0,59,192,251
2023/3/22 12:20,1,14,1,0,65,127,192
2023/3/22 12:30,1,14,1,0,39,83,122
2023/3/22 12:40,1,14,1,0,26,57,83
2023/3/22 12:50,1,14,1,0,17,50,67
2023/3/22 13:00,1,14,1,0,18,30,48
2023/3/22 13:10,1,14,1,0,14,16,30
2023/3/22 13:20,1,14,1,0,16,17,33
2023/3/22 13:30,1,14,1,0,20,18,38
2023/3/22 13:40,1,14,1,0,33,20,53
2023/3/22 13:50,1,14,1,0,27,26,53
2023/3/22 14:00,1,14,1,0,25,21,46
2023/3/22 14:10,1,14,1,0,20,26,46
2023/3/22 14:20,1,14,1,0,19,19,38
2023/3/22 14:30,1,14,1,0,20,21,41
2023/3/22 14:40,1,14,1,0,18,19,37
2023/3/22 14:50,1,14,1,0,21,17,38
2023/3/22 15:00,1,14,1,0,23,14,37
2023/3/22 15:10,1,14,1,0,29,15,44
2023/3/22 15:20,1,14,1,0,24,14,38
2023/3/22 15:30,1,14,1,0,34,18,52
2023/3/22 15:40,1,14,1,0,30,25,55
2023/3/22 15:50,1,14,1,0,36,21,57
2023/3/22 16:00,1,14,1,0,32,16,48
2023/3/22 16:10,1,13,1,0,32,18,50
2023/3/22 16:20,1,13,1,0,29,16,45
2023/3/22 16:30,1,13,1,0,37,15,52
2023/3/22 16:40,1,13,1,0,32,11,43
2023/3/22 16:50,1,13,1,0,38,20,58
2023/3/22 17:00,1,13,1,0,47,24,71
2023/3/22 17:10,1,13,1,0,41,21,62
2023/3/22 17:20,1,13,1,0,49,27,76
2023/3/22 17:30,1,13,1,0,47,30,77
2023/3/22 17:40,1,13,1,0,42,34,76
2023/3/22 17:50,1,13,1,0,51,43,94
2023/3/22 18:00,1,12,1,0,56,40,96
2023/3/22 18:10,1,12,1,0,48,37,85
2023/3/22 18:20,1,12,1,0,55,27,82
2023/3/22 18:30,1,12,1,0,42,31,73
2023/3/22 18:40,1,12,1,0,41,31,72
2023/3/22 18:50,1,12,1,0,43,34,77
2023/3/22 19:00,1,12,1,0,36,24,60
2023/3/22 19:10,1,12,1,0,34,21,55
2023/3/22 19:20,1,12,1,0,32,25,57
2023/3/22 19:30,1,12,1,0,25,25,50
2023/3/22 19:40,1,12,1,0,29,20,49
2023/3/22 19:50,1,12,1,0,24,21,45
2023/3/22 20:00,1,12,1,0,30,25,55
2023/3/22 20:10,1,12,1,0,22,25,47
2023/3/22 20:20,1,12,1,0,19,27,46
2023/3/22 20:30,1,11,1,0,18,34,52
2023/3/22 20:40,1,11,1,0,21,37,58
2023/3/22 20:50,1,11,1,0,19,36,55
2023/3/22 21:00,1,11,1,0,12,36,48
2023/3/22 21:10,1,11,1,0,17,29,46
2023/3/22 21:20,1,11,1,0,13,33,46
2023/3/22 21:30,1,11,1,0,11,26,37
2023/3/22 21:40,1,11,1,0,10,45,55
2023/3/22 21:50,1,11,1,0,8,48,56
2023/3/22 22:00,1,11,1,0,8,45,53
2023/3/22 22:10,1,11,1,0,6,40,46
2023/3/22 22:20,1,10,1,0,2,35,37
2023/3/22 22:30,1,10,1,0,2,23,25
2023/3/22 22:40,1,10,1,0,3,15,18
2023/3/22 22:50,1,10,1,0,4,13,17
2023/3/22 23:00,1,10,1,0,1,5,6
2023/3/22 23:10,1,10,1,0,2,5,7
2023/3/22 23:20,1,10,1,0,0,3,3
2023/3/22 23:30,1,10,1,0,2,1,3
2023/3/22 23:40,1,10,1,0,2,2,4
2023/3/22 23:50,1,10,1,0,0,1,1
2023/3/23 0:00,1,10,1,0,5,2,7
2023/3/23 0:10,1,10,1,0,4,2,6
2023/3/23 0:20,1,10,1,0,3,3,6
2023/3/23 0:30,1,10,1,0,2,1,3
2023/3/23 0:40,1,10,1,0,3,1,4
2023/3/23 0:50,1,10,1,0,1,0,1
2023/3/23 1:00,1,10,1,0,1,2,3
2023/3/23 1:10,1,10,1,0,1,1,2
2023/3/23 1:20,1,10,1,0,2,1,3
2023/3/23 1:30,1,9,1,0,2,1,3
2023/3/23 1:40,1,9,1,0,0,0,0
2023/3/23 1:50,1,9,1,0,1,2,3
2023/3/23 2:00,1,9,1,0,0,0,0
2023/3/23 2:10,1,9,1,0,2,0,2
2023/3/23 2:20,1,9,1,0,2,2,4
2023/3/23 2:30,1,9,1,0,1,0,1
2023/3/23 2:40,1,9,1,0,0,1,1
2023/3/23 2:50,1,9,1,0,1,1,2
2023/3/23 3:00,1,9,1,0,2,0,2
2023/3/23 3:10,1,9,1,0,0,1,1
2023/3/23 3:20,1,9,1,0,1,2,3
2023/3/23 3:30,1,9,1,0,1,1,2
2023/3/23 3:40,1,9,1,0,2,0,2
2023/3/23 3:50,1,9,1,0,2,0,2
2023/3/23 4:00,1,9,1,0,1,1,2
2023/3/23 4:10,1,9,1,0,1,0,1
2023/3/23 4:20,1,9,1,0,1,1,2
2023/3/23 4:30,1,9,1,0,2,1,3
2023/3/23 4:40,1,9,1,0,0,1,1
2023/3/23 4:50,1,9,1,0,1,2,3
2023/3/23 5:00,1,9,1,0,1,1,2
2023/3/23 5:10,1,9,1,0,0,1,1
2023/3/23 5:20,1,9,1,0,2,2,4
2023/3/23 5:30,1,9,1,0,3,0,3
2023/3/23 5:40,1,9,1,0,2,1,3
2023/3/23 5:50,1,9,1,0,3,2,5
2023/3/23 6:00,1,10,1,0,3,2,5
2023/3/23 6:10,1,10,1,0,4,3,7
2023/3/23 6:20,1,10,1,0,4,1,5
2023/3/23 6:30,1,10,1,0,4,4,8
2023/3/23 6:40,1,10,1,0,10,2,12
2023/3/23 6:50,1,10,1,0,42,1,43
2023/3/23 7:00,1,10,1,0,60,4,64
2023/3/23 7:10,1,10,1,0,80,0,80
2023/3/23 7:20,1,11,1,0,99,2,101
2023/3/23 7:30,1,11,1,0,308,1,309
2023/3/23 7:40,1,11,1,0,571,5,576
2023/3/23 7:50,1,11,1,0,530,5,535
2023/3/23 8:00,1,11,1,0,273,6,279
2023/3/23 8:10,1,11,1,0,156,8,164
2023/3/23 8:20,1,11,1,0,84,10,94
2023/3/23 8:30,1,11,1,0,84,15,99
2023/3/23 8:40,1,11,1,0,85,16,101
2023/3/23 8:50,1,11,1,0,80,10,90
2023/3/23 9:00,1,11,1,0,71,15,86
2023/3/23 9:10,1,11,1,0,85,19,104
2023/3/23 9:20,1,11,1,0,162,29,191
2023/3/23 9:30,1,11,1,0,246,42,288
2023/3/23 9:40,1,12,1,0,235,121,356
2023/3/23 9:50,1,12,1,0,167,162,329
2023/3/23 10:00,1,12,1,0,122,136,258
2023/3/23 10:10,1,12,1,0,79,106,185
2023/3/23 10:20,1,12,1,0,76,76,152
2023/3/23 10:30,1,12,1,0,61,46,107
2023/3/23 10:40,1,12,1,0,64,50,114
2023/3/23 10:50,1,12,1,0,60,44,104
2023/3/23 11:00,1,12,1,0,60,42,102
2023/3/23 11:10,1,12,1,0,65,37,102
2023/3/23 11:20,1,12,1,0,55,45,100
2023/3/23 11:30,1,12,1,0,71,74,145
2023/3/23 11:40,1,12,1,0,70,219,289
2023/3/23 11:50,1,12,1,0,59,318,377
2023/3/23 12:00,1,12,1,0,63,288,351
2023/3/23 12:10,1,13,1,0,60,177,237
2023/3/23 12:20,1,13,1,0,54,134,188
2023/3/23 12:30,1,13,1,0,55,91,146
2023/3/23 12:40,1,13,1,0,51,61,112
2023/3/23 12:50,1,13,1,0,53,45,98
2023/3/23 13:00,1,13,1,0,70,27,97
2023/3/23 13:10,1,13,1,0,68,33,101
2023/3/23 13:20,1,14,1,0,77,31,108
2023/3/23 13:30,1,14,1,0,159,36,195
2023/3/23 13:40,1,14,1,0,236,31,267
2023/3/23 13:50,1,14,1,0,238,39,277
2023/3/23 14:00,1,14,1,0,114,33,147
2023/3/23 14:10,1,14,1,0,103,35,138
2023/3/23 14:20,1,14,1,0,96,36,132
2023/3/23 14:30,1,14,1,0,77,42,119
2023/3/23 14:40,1,14,1,0,81,38,119
2023/3/23 14:50,1,14,1,0,67,43,110
2023/3/23 15:00,1,14,1,0,63,46,109
2023/3/23 15:10,1,14,1,0,83,44,127
2023/3/23 15:20,1,14,1,0,80,39,119
2023/3/23 15:30,1,14,1,0,91,58,149
2023/3/23 15:40,1,14,1,0,156,180,336
2023/3/23 15:50,1,14,1,0,161,202,363
2023/3/23 16:00,1,14,1,0,95,155,250
2023/3/23 16:10,1,14,1,0,78,113,191
2023/3/23 16:20,1,14,1,0,81,88,169
2023/3/23 16:30,1,14,1,0,80,78,158
2023/3/23 16:40,1,14,1,0,78,53,131
2023/3/23 16:50,1,14,1,0,83,66,149
2023/3/23 17:00,1,14,1,0,80,53,133
2023/3/23 17:10,1,14,1,0,65,64,129
2023/3/23 17:20,1,14,1,0,87,58,145
2023/3/23 17:30,1,14,1,0,85,82,167
2023/3/23 17:40,1,14,1,0,89,241,330
2023/3/23 17:50,1,14,1,0,109,240,349
2023/3/23 18:00,1,14,1,0,103,208,311
2023/3/23 18:10,1,14,1,0,96,139,235
2023/3/23 18:20,1,14,1,0,85,87,172
2023/3/23 18:30,1,13,1,0,107,78,185
2023/3/23 18:40,1,13,1,0,199,66,265
2023/3/23 18:50,1,13,1,0,162,67,229
2023/3/23 19:00,1,13,1,0,149,62,211
2023/3/23 19:10,1,13,1,0,112,56,168
2023/3/23 19:20,1,13,1,0,100,55,155
2023/3/23 19:30,1,13,1,0,102,68,170
2023/3/23 19:40,1,13,1,0,92,51,143
2023/3/23 19:50,1,13,1,0,78,59,137
2023/3/23 20:00,1,13,1,0,82,72,154
2023/3/23 20:10,1,13,1,0,84,62,146
2023/3/23 20:20,1,13,1,0,69,66,135
2023/3/23 20:30,1,13,1,0,73,92,165
2023/3/23 20:40,1,13,1,0,59,174,233
2023/3/23 20:50,1,13,1,0,50,275,325
2023/3/23 21:00,1,12,1,0,49,146,195
2023/3/23 21:10,1,12,1,0,49,143,192
2023/3/23 21:20,1,12,1,0,30,114,144
2023/3/23 21:30,1,12,1,0,25,79,104
2023/3/23 21:40,1,12,1,0,19,72,91
2023/3/23 21:50,1,12,1,0,15,74,89
2023/3/23 22:00,1,12,1,0,14,89,103
2023/3/23 22:10,1,12,1,0,16,76,92
2023/3/23 22:20,1,12,1,0,17,49,66
2023/3/23 22:30,1,12,1,0,14,39,53
2023/3/23 22:40,1,11,1,0,13,21,34
2023/3/23 22:50,1,11,1,0,12,12,24
2023/3/23 23:00,1,11,1,0,9,10,19
2023/3/23 23:10,1,11,1,0,7,13,20
2023/3/23 23:20,1,11,1,0,7,10,17
2023/3/23 23:30,1,11,1,0,2,7,9
2023/3/23 23:40,1,11,1,0,2,10,12
2023/3/23 23:50,1,11,1,0,1,5,6
2023/3/24 0:00,1,11,1,0,5,0,5
2023/3/24 0:10,1,11,1,0,2,2,4
2023/3/24 0:20,1,11,1,0,3,3,6
2023/3/24 0:30,1,11,1,0,1,1,2
2023/3/24 0:40,1,10,1,0,2,0,2
2023/3/24 0:50,1,10,1,0,0,1,1
2023/3/24 1:00,1,10,1,0,2,1,3
2023/3/24 1:10,1,10,1,0,0,0,0
2023/3/24 1:20,1,10,1,0,0,2,2
2023/3/24 1:30,1,10,1,0,1,0,1
2023/3/24 1:40,1,10,1,0,1,2,3
2023/3/24 1:50,1,10,1,0,2,0,2
2023/3/24 2:00,1,10,1,0,2,2,4
2023/3/24 2:10,1,9,1,0,2,2,4
2023/3/24 2:20,1,9,1,0,1,0,1
2023/3/24 2:30,1,9,1,0,0,0,0
2023/3/24 2:40,1,9,1,0,2,0,2
2023/3/24 2:50,1,9,1,0,2,2,4
2023/3/24 3:00,1,9,1,0,2,1,3
2023/3/24 3:10,1,9,1,0,0,1,1
2023/3/24 3:20,1,9,1,0,1,1,2
2023/3/24 3:30,1,9,1,0,2,0,2
2023/3/24 3:40,1,9,1,0,2,0,2
2023/3/24 3:50,1,9,1,0,2,2,4
2023/3/24 4:00,1,9,1,0,1,1,2
2023/3/24 4:10,1,9,1,0,1,0,1
2023/3/24 4:20,1,9,1,0,0,1,1
2023/3/24 4:30,1,9,1,0,1,1,2
2023/3/24 4:40,1,9,1,0,2,1,3
2023/3/24 4:50,1,9,1,0,1,0,1
2023/3/24 5:00,1,9,1,0,0,0,0
2023/3/24 5:10,1,9,1,0,2,0,2
2023/3/24 5:20,1,9,1,0,1,2,3
2023/3/24 5:30,1,9,1,0,2,0,2
2023/3/24 5:40,1,9,1,0,2,2,4
2023/3/24 5:50,1,9,1,0,3,2,5
2023/3/24 6:00,1,9,1,0,3,4,7
2023/3/24 6:10,1,9,1,0,3,3,6
2023/3/24 6:20,1,9,1,0,7,1,8
2023/3/24 6:30,1,9,1,0,4,2,6
2023/3/24 6:40,1,9,1,0,11,1,12
2023/3/24 6:50,1,9,1,0,39,1,40
2023/3/24 7:00,1,9,1,0,53,4,57
2023/3/24 7:10,1,10,1,0,83,0,83
2023/3/24 7:20,1,10,1,0,118,3,121
2023/3/24 7:30,1,10,1,0,311,2,313
2023/3/24 7:40,1,10,1,0,563,4,567
2023/3/24 7:50,1,10,1,0,682,5,687
2023/3/24 8:00,1,10,1,0,261,6,267
2023/3/24 8:10,1,10,1,0,132,11,143
2023/3/24 8:20,1,10,1,0,86,8,94
2023/3/24 8:30,1,10,1,0,76,13,89
2023/3/24 8:40,1,10,1,0,69,12,81
2023/3/24 8:50,1,10,1,0,69,14,83
2023/3/24 9:00,1,10,1,0,86,16,102
2023/3/24 9:10,1,10,1,0,88,16,104
2023/3/24 9:20,1,10,1,0,145,26,171
2023/3/24 9:30,1,10,1,0,231,39,270
2023/3/24 9:40,1,10,1,0,260,131,391
2023/3/24 9:50,1,10,1,0,191,179,370
2023/3/24 10:00,1,10,1,0,117,135,252
2023/3/24 10:10,1,10,1,0,89,95,184
2023/3/24 10:20,1,10,1,0,84,64,148
2023/3/24 10:30,1,10,1,0,68,52,120
2023/3/24 10:40,1,10,1,0,65,46,111
2023/3/24 10:50,1,10,1,0,65,38,103
2023/3/24 11:00,1,10,1,0,73,42,115
2023/3/24 11:10,1,10,1,0,55,37,92
2023/3/24 11:20,1,10,1,0,60,40,100
2023/3/24 11:30,1,10,1,0,78,79,157
2023/3/24 11:40,1,10,1,0,76,220,296
2023/3/24 11:50,1,10,1,0,62,310,372
2023/3/24 12:00,1,10,1,0,57,239,296
2023/3/24 12:10,1,10,1,0,56,177,233
2023/3/24 12:20,1,10,1,0,64,110,174
2023/3/24 12:30,1,10,1,0,56,84,140
2023/3/24 12:40,1,10,1,0,66,73,139
2023/3/24 12:50,1,10,1,0,62,56,118
2023/3/24 13:00,1,10,1,0,62,30,92
2023/3/24 13:10,1,10,1,0,63,31,94
2023/3/24 13:20,1,10,1,0,88,31,119
2023/3/24 13:30,1,10,1,0,179,30,209
2023/3/24 13:40,1,10,1,0,212,32,244
2023/3/24 13:50,1,10,1,0,220,39,259
2023/3/24 14:00,1,10,1,0,113,27,140
2023/3/24 14:10,1,10,1,0,99,43,142
2023/3/24 14:20,1,9,1,0,95,42,137
2023/3/24 14:30,1,9,1,0,81,47,128
2023/3/24 14:40,1,9,1,0,73,41,114
2023/3/24 14:50,1,9,1,0,71,45,116
2023/3/24 15:00,1,9,1,0,72,45,117
2023/3/24 15:10,1,9,1,0,71,40,111
2023/3/24 15:20,1,9,1,0,81,42,123
2023/3/24 15:30,1,9,1,0,95,67,162
2023/3/24 15:40,1,9,1,0,131,170,301
2023/3/24 15:50,1,9,1,0,166,193,359
2023/3/24 16:00,1,9,1,0,106,142,248
2023/3/24 16:10,1,9,1,0,88,116,204
2023/3/24 16:20,1,9,1,0,85,79,164
2023/3/24 16:30,1,9,1,0,77,64,141
2023/3/24 16:40,1,9,1,0,73,55,128
2023/3/24 16:50,1,9,1,0,71,57,128
2023/3/24 17:00,1,9,1,0,85,64,149
2023/3/24 17:10,1,9,1,0,75,56,131
2023/3/24 17:20,1,9,1,0,80,54,134
2023/3/24 17:30,1,9,1,0,79,83,162
2023/3/24 17:40,1,9,1,0,94,224,318
2023/3/24 17:50,1,9,1,0,103,237,340
2023/3/24 18:00,1,9,1,0,87,232,319
2023/3/24 18:10,1,9,1,0,92,127,219
2023/3/24 18:20,1,8,1,0,101,96,197
2023/3/24 18:30,1,8,1,0,100,81,181
2023/3/24 18:40,1,8,1,0,169,73,242
2023/3/24 18:50,1,8,1,0,147,67,214
2023/3/24 19:00,1,8,1,0,117,67,184
2023/3/24 19:10,1,8,1,0,135,55,190
2023/3/24 19:20,1,8,1,0,100,61,161
2023/3/24 19:30,1,8,1,0,91,61,152
2023/3/24 19:40,1,8,1,0,85,53,138
2023/3/24 19:50,1,8,1,0,79,64,143
2023/3/24 20:00,1,8,1,0,79,63,142
2023/3/24 20:10,1,8,1,0,91,57,148
2023/3/24 20:20,1,8,1,0,80,69,149
2023/3/24 20:30,1,8,1,0,61,83,144
2023/3/24 20:40,1,8,1,0,67,192,259
2023/3/24 20:50,1,8,1,0,59,224,283
2023/3/24 21:00,1,8,1,0,48,182,230
2023/3/24 21:10,1,7,1,0,48,125,173
2023/3/24 21:20,1,7,1,0,31,117,148
2023/3/24 21:30,1,7,1,0,22,68,90
2023/3/24 21:40,1,7,1,0,17,66,83
2023/3/24 21:50,1,7,1,0,17,87,104
2023/3/24 22:00,1,7,1,0,17,94,111
2023/3/24 22:10,1,7,1,0,14,74,88
2023/3/24 22:20,1,7,1,0,16,48,64
2023/3/24 22:30,1,7,1,0,13,37,50
2023/3/24 22:40,1,7,1,0,12,22,34
2023/3/24 22:50,1,7,1,0,12,13,25
2023/3/24 23:00,1,7,1,0,12,14,26
2023/3/24 23:10,1,7,1,0,6,12,18
2023/3/24 23:20,1,7,1,0,5,12,17
2023/3/24 23:30,1,7,1,0,1,9,10
2023/3/24 23:40,1,7,1,0,1,8,9
2023/3/24 23:50,1,7,1,0,1,3,4
2023/3/25 0:00,1,7,0,0,1,3,4
2023/3/25 0:10,1,7,0,0,1,1,2
2023/3/25 0:20,1,7,0,0,2,0,2
2023/3/25 0:30,1,7,0,0,1,0,1
2023/3/25 0:40,1,7,0,0,0,1,1
2023/3/25 0:50,1,7,0,0,0,2,2
2023/3/25 1:00,1,7,0,0,2,1,3
2023/3/25 1:10,1,6,0,0,1,1,2
2023/3/25 1:20,1,6,0,0,1,2,3
2023/3/25 1:30,1,6,0,0,1,1,2
2023/3/25 1:40,1,6,0,0,1,2,3
2023/3/25 1:50,1,6,0,0,1,1,2
2023/3/25 2:00,1,6,0,0,0,0,0
2023/3/25 2:10,1,6,0,0,0,1,1
2023/3/25 2:20,1,6,0,0,0,2,2
2023/3/25 2:30,1,6,0,0,0,2,2
2023/3/25 2:40,1,6,0,0,2,2,4
2023/3/25 2:50,1,6,0,0,0,1,1
2023/3/25 3:00,1,6,0,0,2,1,3
2023/3/25 3:10,1,6,0,0,2,2,4
2023/3/25 3:20,1,6,0,0,0,2,2
2023/3/25 3:30,1,6,0,0,1,0,1
2023/3/25 3:40,1,6,0,0,2,0,2
2023/3/25 3:50,1,6,0,0,1,1,2
2023/3/25 4:00,1,6,0,0,2,1,3
2023/3/25 4:10,1,6,0,0,2,1,3
2023/3/25 4:20,1,6,0,0,1,0,1
2023/3/25 4:30,1,6,0,0,2,0,2
2023/3/25 4:40,1,6,0,0,1,0,1
2023/3/25 4:50,1,6,0,0,2,0,2
2023/3/25 5:00,1,6,0,0,1,1,2
2023/3/25 5:10,1,6,0,0,0,0,0
2023/3/25 5:20,1,6,0,0,3,2,5
2023/3/25 5:30,1,6,0,0,0,0,0
2023/3/25 5:40,1,6,0,0,1,1,2
2023/3/25 5:50,1,6,0,0,2,1,3
2023/3/25 6:00,1,6,0,0,4,1,5
2023/3/25 6:10,1,7,0,0,8,1,9
2023/3/25 6:20,1,7,0,0,7,2,9
2023/3/25 6:30,1,7,0,0,11,4,15
2023/3/25 6:40,1,7,0,0,12,1,13
2023/3/25 6:50,1,7,0,0,11,3,14
2023/3/25 7:00,1,7,0,0,16,0,16
2023/3/25 7:10,1,7,0,0,18,1,19
2023/3/25 7:20,1,7,0,0,38,2,40
2023/3/25 7:30,1,7,0,0,51,5,56
2023/3/25 7:40,1,7,0,0,57,4,61
2023/3/25 7:50,1,8,0,0,51,2,53
2023/3/25 8:00,1,8,0,0,39,6,45
2023/3/25 8:10,1,8,0,0,44,3,47
2023/3/25 8:20,1,8,0,0,31,2,33
2023/3/25 8:30,1,8,0,0,34,3,37
2023/3/25 8:40,1,8,0,0,30,5,35
2023/3/25 8:50,1,8,0,0,33,5,38
2023/3/25 9:00,1,8,0,0,33,2,35
2023/3/25 9:10,1,8,0,0,31,7,38
2023/3/25 9:20,1,8,0,0,37,8,45
2023/3/25 9:30,1,8,0,0,32,16,48
2023/3/25 9:40,1,8,0,0,42,14,56
2023/3/25 9:50,1,8,0,0,44,8,52
2023/3/25 10:00,1,8,0,0,36,14,50
2023/3/25 10:10,1,8,0,0,27,13,40
2023/3/25 10:20,1,8,0,0,21,9,30
2023/3/25 10:30,1,8,0,0,23,12,35
2023/3/25 10:40,1,9,0,0,19,16,35
2023/3/25 10:50,1,9,0,0,16,18,34
2023/3/25 11:00,1,9,0,0,15,16,31
2023/3/25 11:10,1,9,0,0,15,20,35
2023/3/25 11:20,1,9,0,0,12,22,34
2023/3/25 11:30,1,9,0,0,13,21,34
2023/3/25 11:40,1,9,0,0,9,21,30
2023/3/25 11:50,1,9,0,0,13,28,41
2023/3/25 12:00,1,9,0,0,13,30,43
2023/3/25 12:10,1,9,0,0,13,26,39
2023/3/25 12:20,1,9,0,0,14,30,44
2023/3/25 12:30,1,9,0,0,15,27,42
2023/3/25 12:40,1,9,0,0,12,29,41
2023/3/25 12:50,1,9,0,0,8,29,37
2023/3/25 13:00,1,9,0,0,10,23,33
2023/3/25 13:10,1,9,0,0,12,20,32
2023/3/25 13:20,1,9,0,0,14,17,31
2023/3/25 13:30,1,9,0,0,15,17,32
2023/3/25 13:40,1,9,0,0,25,15,40
2023/3/25 13:50,1,10,0,0,23,17,40
2023/3/25 14:00,1,10,0,0,21,18,39
2023/3/25 14:10,1,10,0,0,20,19,39
2023/3/25 14:20,1,10,0,0,16,15,31
2023/3/25 14:30,1,10,0,0,15,18,33
2023/3/25 14:40,1,10,0,0,18,16,34
2023/3/25 14:50,1,10,0,0,20,15,35
2023/3/25 15:00,1,10,0,0,20,12,32
2023/3/25 15:10,1,10,0,0,26,11,37
2023/3/25 15:20,1,10,0,0,22,14,36
2023/3/25 15:30,1,10,0,0,27,16,43
2023/3/25 15:40,1,10,0,0,20,19,39
2023/3/25 15:50,1,10,0,0,27,19,46
2023/3/25 16:00,1,10,0,0,27,15,42
2023/3/25 16:10,1,10,0,0,25,15,40
2023/3/25 16:20,1,10,0,0,27,12,39
2023/3/25 16:30,1,10,0,0,27,10,37
2023/3/25 16:40,1,11,0,0,29,9,38
2023/3/25 16:50,1,11,0,0,35,16,51
2023/3/25 17:00,1,11,0,0,39,17,56
2023/3/25 17:10,1,11,0,0,34,23,57
2023/3/25 17:20,1,11,0,0,42,22,64
2023/3/25 17:30,1,11,0,0,31,23,54
2023/3/25 17:40,1,11,0,0,36,33,69
2023/3/25 17:50,1,11,0,0,39,34,73
2023/3/25 18:00,1,11,0,0,41,34,75
2023/3/25 18:10,1,11,0,0,47,26,73
2023/3/25 18:20,1,11,0,0,46,23,69
2023/3/25 18:30,1,11,0,0,46,32,78
2023/3/25 18:40,1,12,0,0,36,27,63
2023/3/25 18:50,1,12,0,0,38,26,64
2023/3/25 19:00,1,12,0,0,29,23,52
2023/3/25 19:10,1,12,0,0,30,19,49
2023/3/25 19:20,1,12,0,0,22,17,39
2023/3/25 19:30,1,12,0,0,22,21,43
2023/3/25 19:40,1,12,0,0,29,18,47
2023/3/25 19:50,1,12,0,0,20,17,37
2023/3/25 20:00,1,12,0,0,22,21,43
2023/3/25 20:10,1,12,0,0,18,18,36
2023/3/25 20:20,1,12,0,0,17,25,42
2023/3/25 20:30,1,12,0,0,15,30,45
2023/3/25 20:40,1,12,0,0,17,26,43
2023/3/25 20:50,1,12,0,0,13,27,40
2023/3/25 21:00,1,12,0,0,12,39,51
2023/3/25 21:10,1,12,0,0,15,24,39
2023/3/25 21:20,1,12,0,0,11,22,33
2023/3/25 21:30,1,12,0,0,9,24,33
2023/3/25 21:40,1,12,0,0,7,38,45
2023/3/25 21:50,1,12,0,0,9,41,50
2023/3/25 22:00,1,12,0,0,5,37,42
2023/3/25 22:10,1,12,0,0,5,30,35
2023/3/25 22:20,1,12,0,0,3,28,31
2023/3/25 22:30,1,12,0,0,3,15,18
2023/3/25 22:40,1,12,0,0,3,11,14
2023/3/25 22:50,1,11,0,0,4,9,13
2023/3/25 23:00,1,11,0,0,2,4,6
2023/3/25 23:10,1,11,0,0,1,5,6
2023/3/25 23:20,1,11,0,0,1,3,4
2023/3/25 23:30,1,11,0,0,0,2,2
2023/3/25 23:40,1,11,0,0,2,1,3
2023/3/25 23:50,1,11,0,0,0,2,2
2023/3/26 0:00,1,11,0,0,1,2,3
2023/3/26 0:10,1,11,0,0,1,1,2
2023/3/26 0:20,1,11,0,0,0,1,1
2023/3/26 0:30,1,11,0,0,0,0,0
2023/3/26 0:40,1,11,0,0,2,0,2
2023/3/26 0:50,1,11,0,0,2,0,2
2023/3/26 1:00,1,10,0,0,2,0,2
2023/3/26 1:10,1,10,0,0,0,2,2
2023/3/26 1:20,1,10,0,0,0,2,2
2023/3/26 1:30,1,10,0,0,0,1,1
2023/3/26 1:40,1,10,0,0,2,1,3
2023/3/26 1:50,1,10,0,0,2,1,3
2023/3/26 2:00,1,10,0,0,2,2,4
2023/3/26 2:10,1,10,0,0,0,1,1
2023/3/26 2:20,1,10,0,0,2,2,4
2023/3/26 2:30,1,10,0,0,2,1,3
2023/3/26 2:40,1,10,0,0,0,0,0
2023/3/26 2:50,1,10,0,0,2,0,2
2023/3/26 3:00,1,10,0,0,0,0,0
2023/3/26 3:10,1,10,0,0,0,1,1
2023/3/26 3:20,1,10,0,0,0,1,1
2023/3/26 3:30,1,10,0,0,0,0,0
2023/3/26 3:40,1,10,0,0,0,0,0
2023/3/26 3:50,1,10,0,0,0,0,0
2023/3/26 4:00,1,10,0,0,1,0,1
2023/3/26 4:10,1,10,0,0,1,0,1
2023/3/26 4:20,1,10,0,0,1,2,3
2023/3/26 4:30,1,10,0,0,0,1,1
2023/3/26 4:40,1,11,0,0,0,0,0
2023/3/26 4:50,1,11,0,0,2,1,3
2023/3/26 5:00,1,11,0,0,1,1,2
2023/3/26 5:10,1,12,0,0,1,1,2
2023/3/26 5:20,1,12,0,0,1,2,3
2023/3/26 5:30,1,12,0,0,0,0,0
2023/3/26 5:40,1,12,0,0,1,0,1
2023/3/26 5:50,1,12,0,0,3,2,5
2023/3/26 6:00,1,12,0,0,6,0,6
2023/3/26 6:10,1,12,0,0,7,1,8
2023/3/26 6:20,1,12,0,0,6,0,6
2023/3/26 6:30,1,12,0,0,10,4,14
2023/3/26 6:40,1,12,0,0,9,2,11
2023/3/26 6:50,1,12,0,0,9,3,12
2023/3/26 7:00,1,12,0,0,14,2,16
2023/3/26 7:10,1,13,0,0,18,2,20
2023/3/26 7:20,1,13,0,0,36,3,39
2023/3/26 7:30,1,13,0,0,57,5,62
2023/3/26 7:40,1,13,0,0,64,4,68
2023/3/26 7:50,1,13,0,0,55,2,57
2023/3/26 8:00,1,13,0,0,40,6,46
2023/3/26 8:10,1,13,0,0,41,2,43
2023/3/26 8:20,1,14,0,0,32,1,33
2023/3/26 8:30,1,14,0,0,32,2,34
2023/3/26 8:40,1,14,0,0,30,3,33
2023/3/26 8:50,1,14,0,0,33,3,36
2023/3/26 9:00,1,14,0,0,35,4,39
2023/3/26 9:10,1,15,0,0,36,5,41
2023/3/26 9:20,1,15,0,0,35,8,43
2023/3/26 9:30,1,15,0,0,35,15,50
2023/3/26 9:40,1,15,0,0,42,16,58
2023/3/26 9:50,1,15,0,0,44,9,53
2023/3/26 10:00,1,15,0,0,36,15,51
2023/3/26 10:10,1,15,0,0,23,12,35
2023/3/26 10:20,1,15,0,0,21,11,32
2023/3/26 10:30,1,15,0,0,20,14,34
2023/3/26 10:40,1,15,0,0,20,15,35
2023/3/26 10:50,1,15,0,0,21,17,38
2023/3/26 11:00,1,15,0,0,15,17,32
2023/3/26 11:10,1,15,0,0,18,19,37
2023/3/26 11:20,1,15,0,0,10,21,31
2023/3/26 11:30,1,16,0,0,17,23,40
2023/3/26 11:40,1,16,0,0,12,26,38
2023/3/26 11:50,1,16,0,0,11,34,45
2023/3/26 12:00,1,16,0,0,9,31,40
2023/3/26 12:10,1,16,0,0,14,28,42
2023/3/26 12:20,1,16,0,0,11,31,42
2023/3/26 12:30,1,16,0,0,13,34,47
2023/3/26 12:40,1,17,0,0,14,34,48
2023/3/26 12:50,1,17,0,0,9,23,32
2023/3/26 13:00,1,17,0,0,9,24,33
2023/3/26 13:10,1,17,0,0,12,17,29
2023/3/26 13:20,1,17,0,0,13,17,30
2023/3/26 13:30,1,17,0,0,18,17,35
2023/3/26 13:40,1,17,0,0,29,19,48
2023/3/26 13:50,1,17,0,0,27,19,46
2023/3/26 14:00,1,17,0,0,25,17,42
2023/3/26 14:10,1,17,0,0,17,19,36
2023/3/26 14:20,1,17,0,0,16,17,33
2023/3/26 14:30,1,17,0,0,17,15,32
2023/3/26 14:40,1,17,0,0,15,13,28
2023/3/26 14:50,1,17,0,0,20,13,33
2023/3/26 15:00,1,17,0,0,20,12,32
2023/3/26 15:10,1,17,0,0,26,14,40
2023/3/26 15:20,1,16,0,0,25,14,39
2023/3/26 15:30,1,16,0,0,22,18,40
2023/3/26 15:40,1,16,0,0,23,18,41
2023/3/26 15:50,1,16,0,0,25,16,41
2023/3/26 16:00,1,16,0,0,21,16,37
2023/3/26 16:10,1,16,0,0,22,14,36
2023/3/26 16:20,1,16,0,0,22,11,33
2023/3/26 16:30,1,16,0,0,32,13,45
2023/3/26 16:40,1,15,0,0,29,11,40
2023/3/26 16:50,1,15,0,0,37,18,55
2023/3/26 17:00,1,15,0,0,38,17,55
2023/3/26 17:10,1,15,0,0,36,18,54
2023/3/26 17:20,1,15,0,0,38,20,58
2023/3/26 17:30,1,14,0,0,41,25,66
2023/3/26 17:40,1,14,0,0,32,34,66
2023/3/26 17:50,1,14,0,0,36,35,71
2023/3/26 18:00,1,14,0,0,45,35,80
2023/3/26 18:10,1,14,0,0,47,29,76
2023/3/26 18:20,1,14,0,0,45,28,73
2023/3/26 18:30,1,14,0,0,45,30,75
2023/3/26 18:40,1,14,0,0,37,23,60
2023/3/26 18:50,1,14,0,0,34,29,63
2023/3/26 19:00,1,14,0,0,30,22,52
2023/3/26 19:10,1,14,0,0,25,23,48
2023/3/26 19:20,1,14,0,0,24,19,43
2023/3/26 19:30,1,14,0,0,24,19,43
2023/3/26 19:40,1,14,0,0,28,21,49
2023/3/26 19:50,1,14,0,0,21,17,38
2023/3/26 20:00,1,13,0,0,20,20,40
2023/3/26 20:10,1,13,0,0,20,23,43
2023/3/26 20:20,1,13,0,0,14,25,39
2023/3/26 20:30,1,13,0,0,16,31,47
2023/3/26 20:40,1,13,0,0,15,32,47
2023/3/26 20:50,1,13,0,0,15,32,47
2023/3/26 21:00,1,13,0,0,11,34,45
2023/3/26 21:10,1,13,0,0,16,23,39
2023/3/26 21:20,1,13,0,0,10,23,33
2023/3/26 21:30,1,13,0,0,10,21,31
2023/3/26 21:40,1,12,0,0,9,39,48
2023/3/26 21:50,1,12,0,0,9,43,52
2023/3/26 22:00,1,12,0,0,7,33,40
2023/3/26 22:10,1,12,0,0,5,31,36
2023/3/26 22:20,1,12,0,0,2,29,31
2023/3/26 22:30,1,12,0,0,1,17,18
2023/3/26 22:40,1,12,0,0,3,13,16
2023/3/26 22:50,1,12,0,0,4,9,13
2023/3/26 23:00,1,12,0,0,1,4,5
2023/3/26 23:10,1,12,0,0,1,3,4
2023/3/26 23:20,1,12,0,0,1,1,2
2023/3/26 23:30,1,12,0,0,1,1,2
2023/3/26 23:40,1,12,0,0,2,3,5
2023/3/26 23:50,1,11,0,0,1,1,2
2023/3/27 0:00,1,11,1,0,5,1,6
2023/3/27 0:10,1,11,1,0,4,1,5
2023/3/27 0:20,1,11,1,0,2,2,4
2023/3/27 0:30,1,11,1,0,0,0,0
2023/3/27 0:40,1,11,1,0,1,1,2
2023/3/27 0:50,1,11,1,0,1,2,3
2023/3/27 1:00,1,10,1,0,2,1,3
2023/3/27 1:10,1,10,1,0,1,1,2
2023/3/27 1:20,1,10,1,0,1,2,3
2023/3/27 1:30,1,10,1,0,1,1,2
2023/3/27 1:40,1,10,1,0,2,1,3
2023/3/27 1:50,1,10,1,0,0,1,1
2023/3/27 2:00,1,10,1,0,2,2,4
2023/3/27 2:10,1,9,1,0,0,0,0
2023/3/27 2:20,1,9,1,0,2,0,2
2023/3/27 2:30,1,9,1,0,0,1,1
2023/3/27 2:40,1,9,1,0,0,0,0
2023/3/27 2:50,1,9,1,0,2,2,4
2023/3/27 3:00,1,9,1,0,1,2,3
2023/3/27 3:10,1,9,1,0,2,0,2
2023/3/27 3:20,1,9,1,0,0,0,0
2023/3/27 3:30,1,9,1,0,0,2,2
2023/3/27 3:40,1,9,1,0,0,0,0
2023/3/27 3:50,1,9,1,0,0,0,0
2023/3/27 4:00,1,9,1,0,2,2,4
2023/3/27 4:10,1,9,1,0,1,2,3
2023/3/27 4:20,1,9,1,0,1,2,3
2023/3/27 4:30,1,9,1,0,1,1,2
2023/3/27 4:40,1,9,1,0,2,0,2
2023/3/27 4:50,1,9,1,0,2,0,2
2023/3/27 5:00,1,9,1,0,2,2,4
2023/3/27 5:10,1,9,1,0,1,0,1
2023/3/27 5:20,1,9,1,0,0,0,0
2023/3/27 5:30,1,9,1,0,1,0,1
2023/3/27 5:40,1,9,1,0,2,1,3
2023/3/27 5:50,1,9,1,0,5,2,7
2023/3/27 6:00,1,9,1,0,4,2,6
2023/3/27 6:10,1,10,1,0,4,3,7
2023/3/27 6:20,1,10,1,0,6,3,9
2023/3/27 6:30,1,10,1,0,6,4,10
2023/3/27 6:40,1,10,1,0,13,0,13
2023/3/27 6:50,1,10,1,0,35,1,36
2023/3/27 7:00,1,10,1,0,66,2,68
2023/3/27 7:10,1,10,1,0,96,1,97
2023/3/27 7:20,1,10,1,0,115,1,116
2023/3/27 7:30,1,10,1,0,354,2,356
2023/3/27 7:40,1,10,1,0,564,4,568
2023/3/27 7:50,1,10,1,0,559,4,563
2023/3/27 8:00,1,10,1,0,303,8,311
2023/3/27 8:10,1,10,1,0,124,10,134
2023/3/27 8:20,1,10,1,0,88,8,96
2023/3/27 8:30,1,10,1,0,85,11,96
2023/3/27 8:40,1,11,1,0,81,14,95
2023/3/27 8:50,1,11,1,0,66,14,80
2023/3/27 9:00,1,11,1,0,88,16,104
2023/3/27 9:10,1,11,1,0,87,15,102
2023/3/27 9:20,1,11,1,0,141,25,166
2023/3/27 9:30,1,11,1,0,223,42,265
2023/3/27 9:40,1,11,1,0,252,121,373
2023/3/27 9:50,1,11,1,0,177,152,329
2023/3/27 10:00,1,11,1,0,134,167,301
2023/3/27 10:10,1,11,1,0,81,101,182
2023/3/27 10:20,1,11,1,0,72,65,137
2023/3/27 10:30,1,11,1,0,67,51,118
2023/3/27 10:40,1,11,1,0,57,44,101
2023/3/27 10:50,1,11,1,0,75,44,119
2023/3/27 11:00,1,11,1,0,72,39,111
2023/3/27 11:10,1,11,1,0,55,40,95
2023/3/27 11:20,1,11,1,0,67,43,110
2023/3/27 11:30,1,11,1,0,77,69,146
2023/3/27 11:40,1,11,1,0,71,232,303
2023/3/27 11:50,1,11,1,0,70,292,362
2023/3/27 12:00,1,12,1,0,58,238,296
2023/3/27 12:10,1,12,1,0,50,164,214
2023/3/27 12:20,1,12,1,0,66,111,177
2023/3/27 12:30,1,12,1,0,66,76,142
2023/3/27 12:40,1,12,1,0,54,64,118
2023/3/27 12:50,1,12,1,0,61,53,114
2023/3/27 13:00,1,12,1,0,59,26,85
2023/3/27 13:10,1,12,1,0,63,30,93
2023/3/27 13:20,1,12,1,0,76,34,110
2023/3/27 13:30,1,12,1,0,168,33,201
2023/3/27 13:40,1,12,1,0,216,37,253
2023/3/27 13:50,1,12,1,0,273,35,308
2023/3/27 14:00,1,12,1,0,142,28,170
2023/3/27 14:10,1,12,1,0,106,37,143
2023/3/27 14:20,1,12,1,0,110,35,145
2023/3/27 14:30,1,12,1,0,85,41,126
2023/3/27 14:40,1,13,1,0,88,39,127
2023/3/27 14:50,1,13,1,0,72,47,119
2023/3/27 15:00,1,13,1,0,78,40,118
2023/3/27 15:10,1,13,1,0,75,36,111
2023/3/27 15:20,1,13,1,0,80,41,121
2023/3/27 15:30,1,13,1,0,78,58,136
2023/3/27 15:40,1,13,1,0,123,158,281
2023/3/27 15:50,1,13,1,0,173,216,389
2023/3/27 16:00,1,13,1,0,91,131,222
2023/3/27 16:10,1,13,1,0,78,109,187
2023/3/27 16:20,1,13,1,0,85,88,173
2023/3/27 16:30,1,13,1,0,65,65,130
2023/3/27 16:40,1,13,1,0,77,55,132
2023/3/27 16:50,1,14,1,0,71,56,127
2023/3/27 17:00,1,14,1,0,67,51,118
2023/3/27 17:10,1,14,1,0,72,60,132
2023/3/27 17:20,1,14,1,0,87,56,143
2023/3/27 17:30,1,14,1,0,75,85,160
2023/3/27 17:40,1,14,1,0,87,220,307
2023/3/27 17:50,1,14,1,0,90,264,354
2023/3/27 18:00,1,14,1,0,99,191,290
2023/3/27 18:10,1,14,1,0,76,143,219
2023/3/27 18:20,1,14,1,0,94,106,200
2023/3/27 18:30,1,14,1,0,118,84,202
2023/3/27 18:40,1,14,1,0,162,79,241
2023/3/27 18:50,1,14,1,0,163,65,228
2023/3/27 19:00,1,14,1,0,117,63,180
2023/3/27 19:10,1,14,1,0,135,62,197
2023/3/27 19:20,1,14,1,0,105,59,164
2023/3/27 19:30,1,14,1,0,95,67,162
2023/3/27 19:40,1,14,1,0,83,62,145
2023/3/27 19:50,1,14,1,0,79,62,141
2023/3/27 20:00,1,14,1,0,85,61,146
2023/3/27 20:10,1,14,1,0,86,55,141
2023/3/27 20:20,1,14,1,0,74,71,145
2023/3/27 20:30,1,14,1,0,59,82,141
2023/3/27 20:40,1,14,1,0,64,192,256
2023/3/27 20:50,1,14,1,0,58,234,292
2023/3/27 21:00,1,14,1,0,52,166,218
2023/3/27 21:10,1,14,1,0,55,145,200
2023/3/27 21:20,1,14,1,0,29,118,147
2023/3/27 21:30,1,14,1,0,21,64,85
2023/3/27 21:40,1,14,1,0,17,67,84
2023/3/27 21:50,1,14,1,0,18,84,102
2023/3/27 22:00,1,14,1,0,14,87,101
2023/3/27 22:10,1,14,1,0,13,81,94
2023/3/27 22:20,1,14,1,0,15,46,61
2023/3/27 22:30,1,13,1,0,14,30,44
2023/3/27 22:40,1,13,1,0,13,18,31
2023/3/27 22:50,1,13,1,0,8,15,23
2023/3/27 23:00,1,13,1,0,8,10,18
2023/3/27 23:10,1,13,1,0,6,12,18
2023/3/27 23:20,1,13,1,0,4,11,15
2023/3/27 23:30,1,13,1,0,3,8,11
2023/3/27 23:40,1,13,1,0,2,10,12
2023/3/27 23:50,1,13,1,0,1,5,6
2023/3/28 0:00,1,13,1,0,3,0,3
2023/3/28 0:10,1,13,1,0,4,1,5
2023/3/28 0:20,1,13,1,0,2,2,4
2023/3/28 0:30,1,13,1,0,1,2,3
2023/3/28 0:40,1,12,1,0,1,0,1
2023/3/28 0:50,1,12,1,0,1,1,2
2023/3/28 1:00,1,12,1,0,0,2,2
2023/3/28 1:10,1,12,1,0,0,2,2
2023/3/28 1:20,1,12,1,0,2,0,2
2023/3/28 1:30,1,12,1,0,2,2,4
2023/3/28 1:40,1,12,1,0,0,0,0
2023/3/28 1:50,1,12,1,0,0,0,0
2023/3/28 2:00,1,12,1,0,1,1,2
2023/3/28 2:10,1,12,1,0,2,2,4
2023/3/28 2:20,1,12,1,0,1,0,1
2023/3/28 2:30,1,12,1,0,2,2,4
2023/3/28 2:40,1,12,1,0,1,0,1
2023/3/28 2:50,1,12,1,0,1,1,2
2023/3/28 3:00,1,12,1,0,2,2,4
2023/3/28 3:10,1,12,1,0,0,0,0
2023/3/28 3:20,1,12,1,0,1,0,1
2023/3/28 3:30,1,12,1,0,0,0,0
2023/3/28 3:40,1,12,1,0,1,1,2
2023/3/28 3:50,1,12,1,0,2,0,2
2023/3/28 4:00,1,12,1,0,1,2,3
2023/3/28 4:10,1,12,1,0,2,1,3
2023/3/28 4:20,1,12,1,0,1,2,3
2023/3/28 4:30,1,12,1,0,1,0,1
2023/3/28 4:40,1,12,1,0,2,0,2
2023/3/28 4:50,1,12,1,0,2,0,2
2023/3/28 5:00,1,12,1,0,2,0,2
2023/3/28 5:10,1,12,1,0,0,0,0
2023/3/28 5:20,1,12,1,0,1,2,3
2023/3/28 5:30,1,12,1,0,1,2,3
2023/3/28 5:40,1,12,1,0,2,2,4
2023/3/28 5:50,1,12,1,0,4,1,5
2023/3/28 6:00,1,12,1,0,4,2,6
2023/3/28 6:10,1,12,1,0,4,3,7
2023/3/28 6:20,1,13,1,0,5,1,6
2023/3/28 6:30,1,13,1,0,5,2,7
2023/3/28 6:40,1,13,1,0,14,1,15
2023/3/28 6:50,1,13,1,0,41,1,42
2023/3/28 7:00,1,13,1,0,64,3,67
2023/3/28 7:10,1,13,1,0,96,2,98
2023/3/28 7:20,1,13,1,0,109,3,112
2023/3/28 7:30,1,13,1,0,320,1,321
2023/3/28 7:40,1,14,1,0,585,4,589
2023/3/28 7:50,1,14,1,0,553,4,557
2023/3/28 8:00,1,14,1,0,283,6,289
2023/3/28 8:10,1,14,1,0,126,11,137
2023/3/28 8:20,1,14,1,0,91,8,99
2023/3/28 8:30,1,14,1,0,82,13,95
2023/3/28 8:40,1,14,1,0,86,15,101
2023/3/28 8:50,1,14,1,0,73,11,84
2023/3/28 9:00,1,14,1,0,73,15,88
2023/3/28 9:10,1,14,1,0,97,20,117
2023/3/28 9:20,1,14,1,0,152,28,180
2023/3/28 9:30,1,14,1,0,245,38,283
2023/3/28 9:40,1,14,1,0,272,138,410
2023/3/28 9:50,1,14,1,0,213,195,408
2023/3/28 10:00,1,15,1,0,127,139,266
2023/3/28 10:10,1,15,1,0,89,97,186
2023/3/28 10:20,1,15,1,0,80,76,156
2023/3/28 10:30,1,15,1,0,57,48,105
2023/3/28 10:40,1,15,1,0,55,50,105
2023/3/28 10:50,1,15,1,0,69,46,115
2023/3/28 11:00,1,15,1,0,75,39,114
2023/3/28 11:10,1,15,1,0,59,42,101
2023/3/28 11:20,1,15,1,0,54,39,93
2023/3/28 11:30,1,15,1,0,73,79,152
2023/3/28 11:40,1,15,1,0,77,207,284
2023/3/28 11:50,1,15,1,0,65,272,337
2023/3/28 12:00,1,15,1,0,56,252,308
2023/3/28 12:10,1,15,1,0,51,192,243
2023/3/28 12:20,1,15,1,0,67,133,200
2023/3/28 12:30,1,16,1,0,67,84,151
2023/3/28 12:40,1,16,1,0,62,67,129
2023/3/28 12:50,1,16,1,0,53,51,104
2023/3/28 13:00,1,16,1,0,57,33,90
2023/3/28 13:10,1,16,1,0,62,35,97
2023/3/28 13:20,1,16,1,0,80,29,109
2023/3/28 13:30,1,16,1,0,172,37,209
2023/3/28 13:40,1,16,1,0,260,33,293
2023/3/28 13:50,1,16,1,0,272,39,311
2023/3/28 14:00,1,16,1,0,137,29,166
2023/3/28 14:10,1,16,1,0,112,44,156
2023/3/28 14:20,1,16,1,0,93,41,134
2023/3/28 14:30,1,16,1,0,81,47,128
2023/3/28 14:40,1,16,1,0,78,38,116
2023/3/28 14:50,1,16,1,0,80,45,125
2023/3/28 15:00,1,16,1,0,77,40,117
2023/3/28 15:10,1,16,1,0,74,41,115
2023/3/28 15:20,1,16,1,0,80,44,124
2023/3/28 15:30,1,16,1,0,95,69,164
2023/3/28 15:40,1,16,1,0,143,155,298
2023/3/28 15:50,1,16,1,0,145,208,353
2023/3/28 16:00,1,16,1,0,113,159,272
2023/3/28 16:10,1,16,1,0,87,118,205
2023/3/28 16:20,1,16,1,0,72,84,156
2023/3/28 16:30,1,16,1,0,75,76,151
2023/3/28 16:40,1,16,1,0,69,59,128
2023/3/28 16:50,1,16,1,0,65,62,127
2023/3/28 17:00,1,16,1,0,74,57,131
2023/3/28 17:10,1,16,1,0,69,50,119
2023/3/28 17:20,1,16,1,0,85,51,136
2023/3/28 17:30,1,16,1,0,84,76,160
2023/3/28 17:40,1,15,1,0,92,263,355
2023/3/28 17:50,1,15,1,0,87,237,324
2023/3/28 18:00,1,15,1,0,98,191,289
2023/3/28 18:10,1,15,1,0,84,135,219
2023/3/28 18:20,1,15,1,0,104,96,200
2023/3/28 18:30,1,15,1,0,110,88,198
2023/3/28 18:40,1,15,1,0,165,77,242
2023/3/28 18:50,1,15,1,0,175,74,249
2023/3/28 19:00,1,14,1,0,122,69,191
2023/3/28 19:10,1,14,1,0,110,65,175
2023/3/28 19:20,1,14,1,0,98,67,165
2023/3/28 19:30,1,14,1,0,93,54,147
2023/3/28 19:40,1,14,1,0,100,65,165
2023/3/28 19:50,1,14,1,0,80,57,137
2023/3/28 20:00,1,14,1,0,87,71,158
2023/3/28 20:10,1,14,1,0,91,64,155
2023/3/28 20:20,1,14,1,0,75,56,131
2023/3/28 20:30,1,14,1,0,58,88,146
2023/3/28 20:40,1,14,1,0,63,196,259
2023/3/28 20:50,1,14,1,0,59,268,327
2023/3/28 21:00,1,14,1,0,47,160,207
2023/3/28 21:10,1,13,1,0,57,135,192
2023/3/28 21:20,1,13,1,0,27,97,124
2023/3/28 21:30,1,13,1,0,23,74,97
2023/3/28 21:40,1,13,1,0,21,67,88
2023/3/28 21:50,1,13,1,0,18,79,97
2023/3/28 22:00,1,13,1,0,14,91,105
2023/3/28 22:10,1,13,1,0,14,84,98
2023/3/28 22:20,1,13,1,0,16,54,70
2023/3/28 22:30,1,13,1,0,12,34,46
2023/3/28 22:40,1,13,1,0,12,23,35
2023/3/28 22:50,1,13,1,0,8,13,21
2023/3/28 23:00,1,13,1,0,12,11,23
2023/3/28 23:10,1,13,1,0,6,11,17
2023/3/28 23:20,1,13,1,0,5,9,14
2023/3/28 23:30,1,13,1,0,3,7,10
2023/3/28 23:40,1,13,1,0,1,8,9
2023/3/28 23:50,1,13,1,0,2,6,8
2023/3/29 0:00,1,13,1,0,4,2,6
2023/3/29 0:10,1,13,1,0,4,0,4
2023/3/29 0:20,1,13,1,0,3,2,5
2023/3/29 0:30,1,12,1,0,1,1,2
2023/3/29 0:40,1,12,1,0,1,2,3
2023/3/29 0:50,1,12,1,0,0,0,0
2023/3/29 1:00,1,12,1,0,2,0,2
2023/3/29 1:10,1,12,1,0,1,1,2
2023/3/29 1:20,1,12,1,0,2,0,2
2023/3/29 1:30,1,12,1,0,2,0,2
2023/3/29 1:40,1,12,1,0,2,1,3
2023/3/29 1:50,1,12,1,0,1,1,2
2023/3/29 2:00,1,12,1,0,0,2,2
2023/3/29 2:10,1,11,1,0,2,0,2
2023/3/29 2:20,1,11,1,0,2,0,2
2023/3/29 2:30,1,11,1,0,0,2,2
2023/3/29 2:40,1,11,1,0,2,1,3
2023/3/29 2:50,1,11,1,0,2,1,3
2023/3/29 3:00,1,11,1,0,1,1,2
2023/3/29 3:10,1,11,1,0,2,2,4
2023/3/29 3:20,1,11,1,0,2,1,3
2023/3/29 3:30,1,11,1,0,2,0,2
2023/3/29 3:40,1,11,1,0,0,2,2
2023/3/29 3:50,1,11,1,0,1,0,1
2023/3/29 4:00,1,11,1,0,1,2,3
2023/3/29 4:10,1,11,1,0,1,1,2
2023/3/29 4:20,1,11,1,0,1,2,3
2023/3/29 4:30,1,11,1,0,2,2,4
2023/3/29 4:40,1,11,1,0,1,0,1
2023/3/29 4:50,1,11,1,0,2,1,3
2023/3/29 5:00,1,11,1,0,2,2,4
2023/3/29 5:10,1,11,1,0,1,0,1
2023/3/29 5:20,1,11,1,0,2,1,3
2023/3/29 5:30,1,11,1,0,1,2,3
2023/3/29 5:40,1,11,1,0,0,2,2
2023/3/29 5:50,1,11,1,0,5,0,5
2023/3/29 6:00,1,11,1,0,4,2,6
2023/3/29 6:10,1,11,1,0,3,2,5
2023/3/29 6:20,1,12,1,0,4,3,7
2023/3/29 6:30,1,12,1,0,5,2,7
2023/3/29 6:40,1,12,1,0,14,1,15
2023/3/29 6:50,1,12,1,0,40,0,40
2023/3/29 7:00,1,12,1,0,67,4,71
2023/3/29 7:10,1,12,1,0,89,1,90
2023/3/29 7:20,1,12,1,0,105,3,108
2023/3/29 7:30,1,12,1,0,357,0,357
2023/3/29 7:40,1,12,1,0,596,3,599
2023/3/29 7:50,1,12,1,0,635,4,639
2023/3/29 8:00,1,12,1,0,291,5,296
2023/3/29 8:10,1,12,1,0,155,10,165
2023/3/29 8:20,1,12,1,0,105,8,113
2023/3/29 8:30,1,12,1,0,92,13,105
2023/3/29 8:40,1,12,1,0,83,16,99
2023/3/29 8:50,1,12,1,0,75,14,89
2023/3/29 9:00,1,12,1,0,86,14,100
2023/3/29 9:10,1,12,1,0,81,18,99
2023/3/29 9:20,1,12,1,0,157,32,189
2023/3/29 9:30,1,12,1,0,211,48,259
2023/3/29 9:40,1,12,1,0,260,145,405
2023/3/29 9:50,1,12,1,0,192,177,369
2023/3/29 10:00,1,12,1,0,132,137,269
2023/3/29 10:10,1,12,1,0,77,101,178
2023/3/29 10:20,1,12,1,0,73,78,151
2023/3/29 10:30,1,12,1,0,60,49,109
2023/3/29 10:40,1,12,1,0,62,42,104
2023/3/29 10:50,1,12,1,0,71,40,111
2023/3/29 11:00,1,12,1,0,63,38,101
2023/3/29 11:10,1,12,1,0,60,33,93
2023/3/29 11:20,1,12,1,0,59,49,108
2023/3/29 11:30,1,12,1,0,75,64,139
2023/3/29 11:40,1,13,1,0,77,243,320
2023/3/29 11:50,1,13,1,0,61,309,370
2023/3/29 12:00,1,13,1,0,57,236,293
2023/3/29 12:10,1,13,1,0,63,190,253
2023/3/29 12:20,1,13,1,0,59,113,172
2023/3/29 12:30,1,13,1,0,40,97,137
2023/3/29 12:40,1,13,1,0,26,62,88
2023/3/29 12:50,1,13,1,0,20,57,77
2023/3/29 13:00,1,13,1,0,17,30,47
2023/3/29 13:10,1,13,1,0,10,21,31
2023/3/29 13:20,1,13,1,0,14,16,30
2023/3/29 13:30,1,13,1,0,16,17,33
2023/3/29 13:40,1,13,1,0,30,23,53
2023/3/29 13:50,1,13,1,0,32,22,54
2023/3/29 14:00,1,13,1,0,25,23,48
2023/3/29 14:10,1,13,1,0,21,21,42
2023/3/29 14:20,1,13,1,0,21,20,41
2023/3/29 14:30,1,13,1,0,16,19,35
2023/3/29 14:40,1,13,1,0,19,15,34
2023/3/29 14:50,1,13,1,0,21,14,35
2023/3/29 15:00,1,13,1,0,27,11,38
2023/3/29 15:10,1,14,1,0,30,18,48
2023/3/29 15:20,1,14,1,0,29,15,44
2023/3/29 15:30,1,14,1,0,31,21,52
2023/3/29 15:40,1,14,1,0,29,21,50
2023/3/29 15:50,1,14,1,0,35,19,54
2023/3/29 16:00,1,14,1,0,27,17,44
2023/3/29 16:10,1,14,1,0,27,16,43
2023/3/29 16:20,1,14,1,0,33,18,51
2023/3/29 16:30,1,14,1,0,40,15,55
2023/3/29 16:40,1,14,1,0,36,14,50
2023/3/29 16:50,1,14,1,0,43,16,59
2023/3/29 17:00,1,14,1,0,40,21,61
2023/3/29 17:10,1,14,1,0,34,21,55
2023/3/29 17:20,1,14,1,0,42,29,71
2023/3/29 17:30,1,14,1,0,41,30,71
2023/3/29 17:40,1,14,1,0,44,36,80
2023/3/29 17:50,1,14,1,0,45,40,85
2023/3/29 18:00,1,14,1,0,56,37,93
2023/3/29 18:10,1,14,1,0,54,32,86
2023/3/29 18:20,1,14,1,0,55,32,87
2023/3/29 18:30,1,14,1,0,44,39,83
2023/3/29 18:40,1,14,1,0,47,29,76
2023/3/29 18:50,1,14,1,0,51,31,82
2023/3/29 19:00,1,14,1,0,39,24,63
2023/3/29 19:10,1,14,1,0,33,21,54
2023/3/29 19:20,1,14,1,0,27,24,51
2023/3/29 19:30,1,14,1,0,29,25,54
2023/3/29 19:40,1,14,1,0,30,25,55
2023/3/29 19:50,1,14,1,0,27,22,49
2023/3/29 20:00,1,14,1,0,28,24,52
2023/3/29 20:10,1,14,1,0,22,23,45
2023/3/29 20:20,1,14,1,0,17,30,47
2023/3/29 20:30,1,14,1,0,17,39,56
2023/3/29 20:40,1,14,1,0,16,38,54
2023/3/29 20:50,1,14,1,0,18,34,52
2023/3/29 21:00,1,14,1,0,16,46,62
2023/3/29 21:10,1,14,1,0,18,27,45
2023/3/29 21:20,1,14,1,0,11,33,44
2023/3/29 21:30,1,14,1,0,14,32,46
2023/3/29 21:40,1,14,1,0,8,48,56
2023/3/29 21:50,1,14,1,0,11,46,57
2023/3/29 22:00,1,13,1,0,5,43,48
2023/3/29 22:10,1,13,1,0,4,40,44
2023/3/29 22:20,1,13,1,0,2,29,31
2023/3/29 22:30,1,13,1,0,1,19,20
2023/3/29 22:40,1,13,1,0,1,14,15
2023/3/29 22:50,1,13,1,0,3,12,15
2023/3/29 23:00,1,13,1,0,1,8,9
2023/3/29 23:10,1,13,1,0,1,5,6
2023/3/29 23:20,1,13,1,0,1,2,3
2023/3/29 23:30,1,13,1,0,2,0,2
2023/3/29 23:40,1,13,1,0,2,2,4
2023/3/29 23:50,1,13,1,0,2,0,2
2023/3/30 0:00,1,13,1,0,5,2,7
2023/3/30 0:10,1,13,1,0,4,2,6
2023/3/30 0:20,1,13,1,0,4,2,6
2023/3/30 0:30,1,13,1,0,0,0,0
2023/3/30 0:40,1,13,1,0,1,1,2
2023/3/30 0:50,1,13,1,0,2,2,4
2023/3/30 1:00,1,13,1,0,2,1,3
2023/3/30 1:10,1,13,1,0,0,0,0
2023/3/30 1:20,1,13,1,0,1,1,2
2023/3/30 1:30,1,13,1,0,0,2,2
2023/3/30 1:40,1,12,1,0,0,2,2
2023/3/30 1:50,1,12,1,0,0,2,2
2023/3/30 2:00,1,12,1,0,0,2,2
2023/3/30 2:10,1,12,1,0,2,2,4
2023/3/30 2:20,1,12,1,0,2,1,3
2023/3/30 2:30,1,12,1,0,0,1,1
2023/3/30 2:40,1,12,1,0,0,0,0
2023/3/30 2:50,1,12,1,0,2,0,2
2023/3/30 3:00,1,12,1,0,1,1,2
2023/3/30 3:10,1,12,1,0,1,2,3
2023/3/30 3:20,1,12,1,0,2,2,4
2023/3/30 3:30,1,12,1,0,2,1,3
2023/3/30 3:40,1,12,1,0,1,1,2
2023/3/30 3:50,1,12,1,0,1,1,2
2023/3/30 4:00,1,12,1,0,2,1,3
2023/3/30 4:10,1,12,1,0,0,1,1
2023/3/30 4:20,1,12,1,0,2,2,4
2023/3/30 4:30,1,12,1,0,1,1,2
2023/3/30 4:40,1,12,1,0,0,0,0
2023/3/30 4:50,1,12,1,0,0,1,1
2023/3/30 5:00,1,12,1,0,0,1,1
2023/3/30 5:10,1,12,1,0,0,0,0
2023/3/30 5:20,1,13,1,0,1,0,1
2023/3/30 5:30,1,13,1,0,2,2,4
2023/3/30 5:40,1,13,1,0,1,0,1
2023/3/30 5:50,1,13,1,0,4,2,6
2023/3/30 6:00,1,14,1,0,2,2,4
2023/3/30 6:10,1,14,1,0,2,3,5
2023/3/30 6:20,1,14,1,0,5,1,6
2023/3/30 6:30,1,14,1,0,6,2,8
2023/3/30 6:40,1,14,1,0,13,1,14
2023/3/30 6:50,1,15,1,0,39,2,41
2023/3/30 7:00,1,15,1,0,63,2,65
2023/3/30 7:10,1,15,1,0,90,0,90
2023/3/30 7:20,1,15,1,0,123,1,124
2023/3/30 7:30,1,15,1,0,296,1,297
2023/3/30 7:40,1,15,1,0,528,4,532
2023/3/30 7:50,1,15,1,0,602,4,606
2023/3/30 8:00,1,15,1,0,298,5,303
2023/3/30 8:10,1,15,1,0,140,9,149
2023/3/30 8:20,1,16,1,0,85,9,94
2023/3/30 8:30,1,16,1,0,72,11,83
2023/3/30 8:40,1,16,1,0,69,12,81
2023/3/30 8:50,1,16,1,0,82,11,93
2023/3/30 9:00,1,16,1,0,80,13,93
2023/3/30 9:10,1,16,1,0,83,15,98
2023/3/30 9:20,1,16,1,0,149,29,178
2023/3/30 9:30,1,16,1,0,216,44,260
2023/3/30 9:40,1,17,1,0,252,125,377
2023/3/30 9:50,1,17,1,0,192,154,346
2023/3/30 10:00,1,17,1,0,137,165,302
2023/3/30 10:10,1,17,1,0,78,90,168
2023/3/30 10:20,1,17,1,0,71,70,141
2023/3/30 10:30,1,18,1,0,59,48,107
2023/3/30 10:40,1,18,1,0,67,40,107
2023/3/30 10:50,1,18,1,0,75,45,120
2023/3/30 11:00,1,18,1,0,75,40,115
2023/3/30 11:10,1,18,1,0,68,36,104
2023/3/30 11:20,1,19,1,0,56,50,106
2023/3/30 11:30,1,19,1,0,72,70,142
2023/3/30 11:40,1,19,1,0,66,250,316
2023/3/30 11:50,1,19,1,0,69,249,318
2023/3/30 12:00,1,19,1,0,53,273,326
2023/3/30 12:10,1,19,1,0,63,165,228
2023/3/30 12:20,1,19,1,0,53,125,178
2023/3/30 12:30,1,19,1,0,64,85,149
2023/3/30 12:40,1,19,1,0,63,68,131
2023/3/30 12:50,1,19,1,0,56,53,109
2023/3/30 13:00,1,19,1,0,57,33,90
2023/3/30 13:10,1,19,1,0,64,31,95
2023/3/30 13:20,1,20,1,0,83,30,113
2023/3/30 13:30,1,20,1,0,150,35,185
2023/3/30 13:40,1,20,1,0,254,40,294
2023/3/30 13:50,1,20,1,0,262,42,304
2023/3/30 14:00,1,20,1,0,127,30,157
2023/3/30 14:10,1,20,1,0,102,43,145
2023/3/30 14:20,1,20,1,0,110,41,151
2023/3/30 14:30,1,20,1,0,87,45,132
2023/3/30 14:40,1,20,1,0,79,40,119
2023/3/30 14:50,1,20,1,0,73,45,118
2023/3/30 15:00,1,19,1,0,71,51,122
2023/3/30 15:10,1,19,1,0,81,46,127
2023/3/30 15:20,1,19,1,0,83,40,123
2023/3/30 15:30,1,19,1,0,91,72,163
2023/3/30 15:40,1,19,1,0,139,170,309
2023/3/30 15:50,1,19,1,0,146,219,365
2023/3/30 16:00,1,19,1,0,92,138,230
2023/3/30 16:10,1,19,1,0,85,111,196
2023/3/30 16:20,1,19,1,0,85,77,162
2023/3/30 16:30,1,19,1,0,71,71,142
2023/3/30 16:40,1,19,1,0,76,53,129
2023/3/30 16:50,1,18,1,0,65,56,121
2023/3/30 17:00,1,18,1,0,68,60,128
2023/3/30 17:10,1,18,1,0,74,52,126
2023/3/30 17:20,1,18,1,0,77,58,135
2023/3/30 17:30,1,18,1,0,90,73,163
2023/3/30 17:40,1,18,1,0,83,275,358
2023/3/30 17:50,1,18,1,0,89,259,348
2023/3/30 18:00,1,17,1,0,86,181,267
2023/3/30 18:10,1,17,1,0,88,136,224
2023/3/30 18:20,1,17,1,0,84,89,173
2023/3/30 18:30,1,17,1,0,109,86,195
2023/3/30 18:40,1,17,1,0,193,77,270
2023/3/30 18:50,1,17,1,0,176,69,245
2023/3/30 19:00,1,17,1,0,149,66,215
2023/3/30 19:10,1,17,1,0,124,60,184
2023/3/30 19:20,1,16,1,0,107,63,170
2023/3/30 19:30,1,16,1,0,87,59,146
2023/3/30 19:40,1,16,1,0,96,57,153
2023/3/30 19:50,1,16,1,0,85,62,147
2023/3/30 20:00,1,16,1,0,78,61,139
2023/3/30 20:10,1,16,1,0,83,67,150
2023/3/30 20:20,1,16,1,0,82,58,140
2023/3/30 20:30,1,16,1,0,67,89,156
2023/3/30 20:40,1,15,1,0,64,217,281
2023/3/30 20:50,1,15,1,0,62,260,322
2023/3/30 21:00,1,15,1,0,42,170,212
2023/3/30 21:10,1,15,1,0,53,131,184
2023/3/30 21:20,1,15,1,0,30,121,151
2023/3/30 21:30,1,15,1,0,25,74,99
2023/3/30 21:40,1,15,1,0,20,70,90
2023/3/30 21:50,1,14,1,0,18,83,101
2023/3/30 22:00,1,14,1,0,14,76,90
2023/3/30 22:10,1,14,1,0,14,76,90
2023/3/30 22:20,1,14,1,0,18,49,67
2023/3/30 22:30,1,14,1,0,14,31,45
2023/3/30 22:40,1,14,1,0,9,21,30
2023/3/30 22:50,1,14,1,0,10,12,22
2023/3/30 23:00,1,14,1,0,9,10,19
2023/3/30 23:10,1,13,1,0,7,11,18
2023/3/30 23:20,1,13,1,0,6,11,17
2023/3/30 23:30,1,13,1,0,2,9,11
2023/3/30 23:40,1,13,1,0,1,11,12
2023/3/30 23:50,1,13,1,0,1,3,4
2023/3/31 0:00,1,13,1,0,3,1,4
2023/3/31 0:10,1,13,1,0,2,2,4
2023/3/31 0:20,1,13,1,0,2,2,4
2023/3/31 0:30,1,12,1,0,1,0,1
2023/3/31 0:40,1,12,1,0,3,1,4
2023/3/31 0:50,1,12,1,0,0,2,2
2023/3/31 1:00,1,12,1,0,2,1,3
2023/3/31 1:10,1,12,1,0,0,0,0
2023/3/31 1:20,1,12,1,0,1,0,1
2023/3/31 1:30,1,12,1,0,1,0,1
2023/3/31 1:40,1,12,1,0,2,2,4
2023/3/31 1:50,1,12,1,0,2,1,3
2023/3/31 2:00,1,12,1,0,1,2,3
2023/3/31 2:10,1,11,1,0,2,0,2
2023/3/31 2:20,1,11,1,0,0,0,0
2023/3/31 2:30,1,11,1,0,1,1,2
2023/3/31 2:40,1,11,1,0,1,1,2
2023/3/31 2:50,1,11,1,0,0,0,0
2023/3/31 3:00,1,11,1,0,1,1,2
2023/3/31 3:10,1,11,1,0,0,1,1
2023/3/31 3:20,1,11,1,0,1,2,3
2023/3/31 3:30,1,11,1,0,2,0,2
2023/3/31 3:40,1,11,1,0,2,2,4
2023/3/31 3:50,1,11,1,0,2,0,2
2023/3/31 4:00,1,11,1,0,0,0,0
2023/3/31 4:10,1,11,1,0,1,2,3
2023/3/31 4:20,1,12,1,0,1,2,3
2023/3/31 4:30,1,12,1,0,2,2,4
2023/3/31 4:40,1,12,1,0,2,0,2
2023/3/31 4:50,1,12,1,0,1,1,2
2023/3/31 5:00,1,12,1,0,1,1,2
2023/3/31 5:10,1,13,1,0,0,1,1
2023/3/31 5:20,1,13,1,0,1,1,2
2023/3/31 5:30,1,13,1,0,3,2,5
2023/3/31 5:40,1,13,1,0,1,0,1
2023/3/31 5:50,1,14,1,0,4,0,4
2023/3/31 6:00,1,14,1,0,3,2,5
2023/3/31 6:10,1,14,1,0,2,2,4
2023/3/31 6:20,1,14,1,0,7,1,8
2023/3/31 6:30,1,15,1,0,7,4,11
2023/3/31 6:40,1,15,1,0,13,1,14
2023/3/31 6:50,1,15,1,0,42,1,43
2023/3/31 7:00,1,15,1,0,66,3,69
2023/3/31 7:10,1,15,1,0,81,1,82
2023/3/31 7:20,1,15,1,0,116,2,118
2023/3/31 7:30,1,15,1,0,283,2,285
2023/3/31 7:40,1,16,1,0,576,3,579
2023/3/31 7:50,1,16,1,0,569,3,572
2023/3/31 8:00,1,16,1,0,281,7,288
2023/3/31 8:10,1,16,1,0,129,8,137
2023/3/31 8:20,1,16,1,0,98,10,108
2023/3/31 8:30,1,16,1,0,88,15,103
2023/3/31 8:40,1,16,1,0,89,12,101
2023/3/31 8:50,1,16,1,0,83,14,97
2023/3/31 9:00,1,17,1,0,83,15,98
2023/3/31 9:10,1,17,1,0,90,18,108
2023/3/31 9:20,1,17,1,0,158,27,185
2023/3/31 9:30,1,17,1,0,209,42,251
2023/3/31 9:40,1,17,1,0,239,123,362
2023/3/31 9:50,1,17,1,0,184,195,379
2023/3/31 10:00,1,17,1,0,124,142,266
2023/3/31 10:10,1,17,1,0,76,87,163
2023/3/31 10:20,1,18,1,0,77,65,142
2023/3/31 10:30,1,18,1,0,68,47,115
2023/3/31 10:40,1,18,1,0,68,48,116
2023/3/31 10:50,1,18,1,0,63,40,103
2023/3/31 11:00,1,18,1,0,75,34,109
2023/3/31 11:10,1,18,1,0,58,35,93
2023/3/31 11:20,1,18,1,0,66,39,105
2023/3/31 11:30,1,18,1,0,67,77,144
2023/3/31 11:40,1,18,1,0,68,237,305
2023/3/31 11:50,1,18,1,0,60,294,354
2023/3/31 12:00,1,19,1,0,54,290,344
2023/3/31 12:10,1,19,1,0,53,191,244
2023/3/31 12:20,1,19,1,0,60,116,176
2023/3/31 12:30,1,20,1,0,68,78,146
2023/3/31 12:40,1,20,1,0,58,74,132
2023/3/31 12:50,1,20,1,0,60,47,107
2023/3/31 13:00,1,20,1,0,60,28,88
2023/3/31 13:10,1,20,1,0,65,32,97
2023/3/31 13:20,1,20,1,0,90,36,126
2023/3/31 13:30,1,20,1,0,144,34,178
2023/3/31 13:40,1,21,1,0,248,40,288
2023/3/31 13:50,1,21,1,0,270,41,311
2023/3/31 14:00,1,21,1,0,141,34,175
2023/3/31 14:10,1,21,1,0,109,45,154
2023/3/31 14:20,1,21,1,0,96,41,137
2023/3/31 14:30,1,21,1,0,76,38,114
2023/3/31 14:40,1,21,1,0,77,49,126
2023/3/31 14:50,1,21,1,0,76,38,114
2023/3/31 15:00,1,22,1,0,74,42,116
2023/3/31 15:10,1,22,1,0,75,36,111
2023/3/31 15:20,1,22,1,0,86,41,127
2023/3/31 15:30,1,22,1,0,92,60,152
2023/3/31 15:40,1,22,1,0,153,160,313
2023/3/31 15:50,1,22,1,0,169,202,371
2023/3/31 16:00,1,22,1,0,93,134,227
2023/3/31 16:10,1,22,1,0,100,122,222
2023/3/31 16:20,1,22,1,0,70,89,159
2023/3/31 16:30,1,23,1,0,65,62,127
2023/3/31 16:40,1,23,1,0,74,59,133
2023/3/31 16:50,1,23,1,0,65,58,123
2023/3/31 17:00,1,24,1,0,72,53,125
2023/3/31 17:10,1,24,1,0,60,52,112
2023/3/31 17:20,1,24,1,0,80,52,132
2023/3/31 17:30,1,24,1,0,76,83,159
2023/3/31 17:40,1,24,1,0,97,235,332
2023/3/31 17:50,1,24,1,0,94,227,321
2023/3/31 18:00,1,24,1,0,90,214,304
2023/3/31 18:10,1,24,1,0,79,155,234
2023/3/31 18:20,1,24,1,0,99,88,187
2023/3/31 18:30,1,24,1,0,122,89,211
2023/3/31 18:40,1,24,1,0,202,74,276
2023/3/31 18:50,1,24,1,0,185,72,257
2023/3/31 19:00,1,23,1,0,145,64,209
2023/3/31 19:10,1,23,1,0,116,54,170
2023/3/31 19:20,1,23,1,0,102,57,159
2023/3/31 19:30,1,23,1,0,83,63,146
2023/3/31 19:40,1,23,1,0,87,59,146
2023/3/31 19:50,1,23,1,0,76,57,133
2023/3/31 20:00,1,22,1,0,85,64,149
2023/3/31 20:10,1,22,1,0,76,59,135
2023/3/31 20:20,1,22,1,0,86,64,150
2023/3/31 20:30,1,22,1,0,71,85,156
2023/3/31 20:40,1,22,1,0,65,216,281
2023/3/31 20:50,1,22,1,0,60,277,337
2023/3/31 21:00,1,22,1,0,53,162,215
2023/3/31 21:10,1,22,1,0,47,124,171
2023/3/31 21:20,1,21,1,0,29,119,148
2023/3/31 21:30,1,21,1,0,22,77,99
2023/3/31 21:40,1,21,1,0,19,80,99
2023/3/31 21:50,1,21,1,0,18,81,99
2023/3/31 22:00,1,21,1,0,16,89,105
2023/3/31 22:10,1,21,1,0,13,67,80
2023/3/31 22:20,1,21,1,0,17,52,69
2023/3/31 22:30,1,21,1,0,12,38,50
2023/3/31 22:40,1,20,1,0,10,20,30
2023/3/31 22:50,1,20,1,0,10,14,24
2023/3/31 23:00,1,20,1,0,11,10,21
2023/3/31 23:10,1,20,1,0,8,13,21
2023/3/31 23:20,1,20,1,0,4,12,16
2023/3/31 23:30,1,20,1,0,3,7,10
2023/3/31 23:40,1,20,1,0,2,8,10
2023/3/31 23:50,1,19,1,0,0,3,3
2023/4/1 0:00,1,19,0,0,1,2,3
2023/4/1 0:10,1,19,0,0,1,2,3
2023/4/1 0:20,1,19,0,0,2,1,3
2023/4/1 0:30,1,19,0,0,0,0,0
2023/4/1 0:40,1,19,0,0,0,2,2
2023/4/1 0:50,1,18,0,0,2,1,3
2023/4/1 1:00,1,18,0,0,0,2,2
2023/4/1 1:10,1,18,0,0,1,2,3
2023/4/1 1:20,1,18,0,0,1,0,1
2023/4/1 1:30,1,18,0,0,2,2,4
2023/4/1 1:40,1,18,0,0,1,1,2
2023/4/1 1:50,1,17,0,0,0,0,0
2023/4/1 2:00,1,17,0,0,0,1,1
2023/4/1 2:10,1,17,0,0,2,1,3
2023/4/1 2:20,1,17,0,0,1,1,2
2023/4/1 2:30,1,17,0,0,1,2,3
2023/4/1 2:40,1,17,0,0,1,2,3
2023/4/1 2:50,1,17,0,0,2,0,2
2023/4/1 3:00,1,17,0,0,1,0,1
2023/4/1 3:10,1,17,0,0,0,1,1
2023/4/1 3:20,1,16,0,0,1,2,3
2023/4/1 3:30,1,16,0,0,1,2,3
2023/4/1 3:40,1,16,0,0,1,2,3
2023/4/1 3:50,1,16,0,0,1,0,1
2023/4/1 4:00,1,16,0,0,1,2,3
2023/4/1 4:10,1,16,0,0,0,1,1
2023/4/1 4:20,1,16,0,0,1,0,1
2023/4/1 4:30,1,16,0,0,2,1,3
2023/4/1 4:40,1,16,0,0,2,2,4
2023/4/1 4:50,1,17,0,0,2,1,3
2023/4/1 5:00,1,17,0,0,1,1,2
2023/4/1 5:10,1,17,0,0,1,2,3
2023/4/1 5:20,1,17,0,0,1,0,1
2023/4/1 5:30,1,17,0,0,2,1,3
2023/4/1 5:40,1,17,0,0,2,1,3
2023/4/1 5:50,1,17,0,0,3,2,5
2023/4/1 6:00,1,17,0,0,5,2,7
2023/4/1 6:10,1,17,0,0,7,1,8
2023/4/1 6:20,1,17,0,0,8,2,10
2023/4/1 6:30,1,17,0,0,10,3,13
2023/4/1 6:40,1,18,0,0,13,0,13
2023/4/1 6:50,1,18,0,0,11,4,15
2023/4/1 7:00,1,18,0,0,13,0,13
2023/4/1 7:10,1,19,0,0,23,1,24
2023/4/1 7:20,1,19,0,0,44,1,45
2023/4/1 7:30,1,19,0,0,45,3,48
2023/4/1 7:40,1,19,0,0,62,2,64
2023/4/1 7:50,1,19,0,0,48,3,51
2023/4/1 8:00,1,19,0,0,41,3,44
2023/4/1 8:10,1,19,0,0,39,2,41
2023/4/1 8:20,1,19,0,0,28,2,30
2023/4/1 8:30,1,20,0,0,30,3,33
2023/4/1 8:40,1,20,0,0,30,5,35
2023/4/1 8:50,1,20,0,0,28,3,31
2023/4/1 9:00,1,20,0,0,33,4,37
2023/4/1 9:10,1,20,0,0,33,4,37
2023/4/1 9:20,1,21,0,0,30,5,35
2023/4/1 9:30,1,21,0,0,34,12,46
2023/4/1 9:40,1,21,0,0,39,14,53
2023/4/1 9:50,1,21,0,0,37,8,45
2023/4/1 10:00,1,21,0,0,30,14,44
2023/4/1 10:10,1,22,0,0,21,12,33
2023/4/1 10:20,1,22,0,0,23,10,33
2023/4/1 10:30,1,22,0,0,21,11,32
2023/4/1 10:40,1,22,0,0,19,15,34
2023/4/1 10:50,1,22,0,0,16,18,34
2023/4/1 11:00,1,22,0,0,15,18,33
2023/4/1 11:10,1,22,0,0,18,20,38
2023/4/1 11:20,1,23,0,0,10,19,29
2023/4/1 11:30,1,23,0,0,13,19,32
2023/4/1 11:40,1,23,0,0,12,21,33
2023/4/1 11:50,1,23,0,0,13,31,44
2023/4/1 12:00,1,23,0,0,9,34,43
2023/4/1 12:10,1,23,0,0,13,28,41
2023/4/1 12:20,1,23,0,0,11,26,37
2023/4/1 12:30,1,24,0,0,14,29,43
2023/4/1 12:40,1,24,0,0,13,29,42
2023/4/1 12:50,1,24,0,0,9,29,38
2023/4/1 13:00,1,24,0,0,10,22,32
2023/4/1 13:10,1,24,0,0,12,16,28
2023/4/1 13:20,1,24,0,0,15,16,31
2023/4/1 13:30,1,24,0,0,16,15,31
2023/4/1 13:40,1,25,0,0,23,20,43
2023/4/1 13:50,1,25,0,0,21,21,42
2023/4/1 14:00,1,25,0,0,25,20,45
2023/4/1 14:10,1,25,0,0,20,21,41
2023/4/1 14:20,1,25,0,0,16,16,32
2023/4/1 14:30,1,25,0,0,13,15,28
2023/4/1 14:40,1,25,0,0,18,12,30
2023/4/1 14:50,1,25,0,0,17,15,32
2023/4/1 15:00,1,25,0,0,20,9,29
2023/4/1 15:10,1,25,0,0,23,12,35
2023/4/1 15:20,1,25,0,0,21,13,34
2023/4/1 15:30,1,25,0,0,29,16,45
2023/4/1 15:40,1,26,0,0,22,18,40
2023/4/1 15:50,1,26,0,0,31,18,49
2023/4/1 16:00,1,27,0,0,25,17,42
2023/4/1 16:10,1,27,0,0,26,17,43
2023/4/1 16:20,1,27,0,0,22,15,37
2023/4/1 16:30,1,27,0,0,29,12,41
2023/4/1 16:40,1,27,0,0,27,9,36
2023/4/1 16:50,1,27,0,0,35,14,49
2023/4/1 17:00,1,27,0,0,32,16,48
2023/4/1 17:10,1,27,0,0,29,23,52
2023/4/1 17:20,1,27,0,0,35,22,57
2023/4/1 17:30,1,27,0,0,31,21,52
2023/4/1 17:40,1,27,0,0,38,32,70
2023/4/1 17:50,1,27,0,0,34,38,72
2023/4/1 18:00,1,27,0,0,48,37,85
2023/4/1 18:10,1,26,0,0,47,29,76
2023/4/1 18:20,1,26,0,0,48,30,78
2023/4/1 18:30,1,26,0,0,43,29,72
2023/4/1 18:40,1,26,0,0,34,29,63
2023/4/1 18:50,1,26,0,0,38,27,65
2023/4/1 19:00,1,26,0,0,32,21,53
2023/4/1 19:10,1,26,0,0,28,18,46
2023/4/1 19:20,1,26,0,0,23,17,40
2023/4/1 19:30,1,26,0,0,22,21,43
2023/4/1 19:40,1,26,0,0,27,18,45
2023/4/1 19:50,1,25,0,0,23,18,41
2023/4/1 20:00,1,25,0,0,23,23,46
2023/4/1 20:10,1,25,0,0,15,22,37
2023/4/1 20:20,1,24,0,0,18,20,38
2023/4/1 20:30,1,24,0,0,16,28,44
2023/4/1 20:40,1,24,0,0,14,34,48
2023/4/1 20:50,1,24,0,0,13,32,45
2023/4/1 21:00,1,24,0,0,11,34,45
2023/4/1 21:10,1,23,0,0,14,29,43
2023/4/1 21:20,1,23,0,0,11,24,35
2023/4/1 21:30,1,23,0,0,11,24,35
2023/4/1 21:40,1,23,0,0,6,42,48
2023/4/1 21:50,1,23,0,0,7,36,43
2023/4/1 22:00,1,23,0,0,4,35,39
2023/4/1 22:10,1,23,0,0,4,32,36
2023/4/1 22:20,1,23,0,0,4,25,29
2023/4/1 22:30,1,23,0,0,3,18,21
2023/4/1 22:40,1,23,0,0,3,12,15
2023/4/1 22:50,1,23,0,0,3,9,12
2023/4/1 23:00,1,23,0,0,1,6,7
2023/4/1 23:10,1,22,0,0,1,6,7
2023/4/1 23:20,1,22,0,0,0,2,2
2023/4/1 23:30,1,22,0,0,1,2,3
2023/4/1 23:40,1,22,0,0,2,2,4
2023/4/1 23:50,1,22,0,0,1,0,1
2023/4/2 0:00,1,22,0,0,1,2,3
2023/4/2 0:10,1,22,0,0,2,1,3
2023/4/2 0:20,1,21,0,0,1,0,1
2023/4/2 0:30,1,21,0,0,1,1,2
2023/4/2 0:40,1,21,0,0,0,2,2
2023/4/2 0:50,1,21,0,0,1,0,1
2023/4/2 1:00,1,20,0,0,2,1,3
2023/4/2 1:10,1,20,0,0,1,2,3
2023/4/2 1:20,1,20,0,0,2,2,4
2023/4/2 1:30,1,20,0,0,2,1,3
2023/4/2 1:40,1,20,0,0,0,2,2
2023/4/2 1:50,1,20,0,0,0,2,2
2023/4/2 2:00,1,20,0,0,1,2,3
2023/4/2 2:10,1,20,0,0,1,0,1
2023/4/2 2:20,1,20,0,0,2,1,3
2023/4/2 2:30,1,20,0,0,1,0,1
2023/4/2 2:40,1,19,0,0,1,1,2
2023/4/2 2:50,1,19,0,0,1,1,2
2023/4/2 3:00,1,19,0,0,0,0,0
2023/4/2 3:10,1,19,0,0,2,0,2
2023/4/2 3:20,1,19,0,0,1,0,1
2023/4/2 3:30,1,19,0,0,2,0,2
2023/4/2 3:40,1,19,0,0,0,2,2
2023/4/2 3:50,1,19,0,0,2,1,3
2023/4/2 4:00,1,19,0,0,0,2,2
2023/4/2 4:10,1,19,0,0,2,1,3
2023/4/2 4:20,1,19,0,0,2,2,4
2023/4/2 4:30,1,19,0,0,0,2,2
2023/4/2 4:40,1,19,0,0,0,0,0
2023/4/2 4:50,1,19,0,0,0,1,1
2023/4/2 5:00,1,20,0,0,1,0,1
2023/4/2 5:10,1,20,0,0,1,2,3
2023/4/2 5:20,1,20,0,0,3,1,4
2023/4/2 5:30,1,20,0,0,0,2,2
2023/4/2 5:40,1,20,0,0,2,1,3
2023/4/2 5:50,1,21,0,0,4,0,4
2023/4/2 6:00,1,21,0,0,5,2,7
2023/4/2 6:10,1,21,0,0,9,1,10
2023/4/2 6:20,1,21,0,0,7,0,7
2023/4/2 6:30,1,21,0,0,8,3,11
2023/4/2 6:40,1,21,0,0,11,2,13
2023/4/2 6:50,1,21,0,0,8,3,11
2023/4/2 7:00,1,21,0,0,17,2,19
2023/4/2 7:10,1,21,0,0,21,2,23
2023/4/2 7:20,1,22,0,0,46,1,47
2023/4/2 7:30,1,22,0,0,50,4,54
2023/4/2 7:40,1,22,0,0,60,4,64
2023/4/2 7:50,1,22,0,0,63,2,65
2023/4/2 8:00,1,22,0,0,44,6,50
2023/4/2 8:10,1,22,0,0,44,2,46
2023/4/2 8:20,1,22,0,0,34,2,36
2023/4/2 8:30,1,22,0,0,36,1,37
2023/4/2 8:40,1,23,0,0,31,5,36
2023/4/2 8:50,1,23,0,0,34,3,37
2023/4/2 9:00,1,23,0,0,33,4,37
2023/4/2 9:10,1,23,0,0,29,5,34
2023/4/2 9:20,1,23,0,0,30,7,37
2023/4/2 9:30,1,23,0,0,33,14,47
2023/4/2 9:40,1,24,0,0,37,15,52
2023/4/2 9:50,1,24,0,0,39,11,50
2023/4/2 10:00,1,24,0,0,34,17,51
2023/4/2 10:10,1,24,0,0,25,13,38
2023/4/2 10:20,1,25,0,0,24,8,32
2023/4/2 10:30,1,25,0,0,21,14,35
2023/4/2 10:40,1,25,0,0,22,15,37
2023/4/2 10:50,1,25,0,0,21,16,37
2023/4/2 11:00,1,25,0,0,15,17,32
2023/4/2 11:10,1,25,0,0,15,18,33
2023/4/2 11:20,1,25,0,0,11,19,30
2023/4/2 11:30,1,25,0,0,17,19,36
2023/4/2 11:40,1,25,0,0,9,24,33
2023/4/2 11:50,1,25,0,0,13,33,46
2023/4/2 12:00,1,26,0,0,13,30,43
2023/4/2 12:10,1,26,0,0,14,27,41
2023/4/2 12:20,1,26,0,0,13,27,40
2023/4/2 12:30,1,26,0,0,15,26,41
2023/4/2 12:40,1,26,0,0,12,30,42
2023/4/2 12:50,1,26,0,0,10,30,40
2023/4/2 13:00,1,26,0,0,8,22,30
2023/4/2 13:10,1,26,0,0,10,17,27
2023/4/2 13:20,1,26,0,0,14,16,30
2023/4/2 13:30,1,26,0,0,18,15,33
2023/4/2 13:40,1,26,0,0,26,16,42
2023/4/2 13:50,1,26,0,0,22,18,40
2023/4/2 14:00,1,26,0,0,23,16,39
2023/4/2 14:10,1,26,0,0,20,18,38
2023/4/2 14:20,1,26,0,0,15,17,32
2023/4/2 14:30,1,26,0,0,14,19,33
2023/4/2 14:40,1,26,0,0,17,15,32
2023/4/2 14:50,1,25,0,0,16,15,31
2023/4/2 15:00,1,25,0,0,21,13,34
2023/4/2 15:10,1,25,0,0,22,14,36
2023/4/2 15:20,1,25,0,0,24,15,39
2023/4/2 15:30,1,25,0,0,29,15,44
2023/4/2 15:40,1,25,0,0,25,16,41
2023/4/2 15:50,1,25,0,0,28,15,43
2023/4/2 16:00,1,25,0,0,21,13,34
2023/4/2 16:10,1,25,0,0,25,17,42
2023/4/2 16:20,1,25,0,0,24,12,36
2023/4/2 16:30,1,24,0,0,29,11,40
2023/4/2 16:40,1,24,0,0,29,12,41
2023/4/2 16:50,1,24,0,0,33,14,47
2023/4/2 17:00,1,24,0,0,31,19,50
2023/4/2 17:10,1,24,0,0,32,21,53
2023/4/2 17:20,1,24,0,0,38,20,58
2023/4/2 17:30,1,24,0,0,37,25,62
2023/4/2 17:40,1,24,0,0,30,30,60
2023/4/2 17:50,1,23,0,0,34,33,67
2023/4/2 18:00,1,23,0,0,52,30,82
2023/4/2 18:10,1,23,0,0,45,32,77
2023/4/2 18:20,1,23,0,0,40,26,66
2023/4/2 18:30,1,23,0,0,39,32,71
2023/4/2 18:40,1,23,0,0,44,27,71
2023/4/2 18:50,1,23,0,0,41,26,67
2023/4/2 19:00,1,23,0,0,31,23,54
2023/4/2 19:10,1,22,0,0,25,22,47
2023/4/2 19:20,1,22,0,0,26,20,46
2023/4/2 19:30,1,22,0,0,26,19,45
2023/4/2 19:40,1,22,0,0,24,18,42
2023/4/2 19:50,1,22,0,0,21,19,40
2023/4/2 20:00,1,22,0,0,25,22,47
2023/4/2 20:10,1,22,0,0,17,23,40
2023/4/2 20:20,1,22,0,0,18,26,44
2023/4/2 20:30,1,21,0,0,19,26,45
2023/4/2 20:40,1,21,0,0,16,27,43
2023/4/2 20:50,1,21,0,0,16,27,43
2023/4/2 21:00,1,21,0,0,11,33,44
2023/4/2 21:10,1,21,0,0,15,30,45
2023/4/2 21:20,1,21,0,0,13,25,38
2023/4/2 21:30,1,21,0,0,12,26,38
2023/4/2 21:40,1,20,0,0,9,43,52
2023/4/2 21:50,1,20,0,0,9,43,52
2023/4/2 22:00,1,20,0,0,7,41,48
2023/4/2 22:10,1,20,0,0,3,33,36
2023/4/2 22:20,1,20,0,0,3,25,28
2023/4/2 22:30,1,20,0,0,3,16,19
2023/4/2 22:40,1,20,0,0,1,14,15
2023/4/2 22:50,1,19,0,0,4,8,12
2023/4/2 23:00,1,19,0,0,2,7,9
2023/4/2 23:10,1,19,0,0,2,5,7
2023/4/2 23:20,1,18,0,0,0,1,1
2023/4/2 23:30,1,18,0,0,2,1,3
2023/4/2 23:40,1,18,0,0,2,3,5
2023/4/2 23:50,1,18,0,0,1,0,1
2023/4/3 0:00,1,18,1,0,4,2,6
2023/4/3 0:10,1,18,1,0,4,2,6
2023/4/3 0:20,1,18,1,0,4,1,5
2023/4/3 0:30,1,17,1,0,0,2,2
2023/4/3 0:40,1,17,1,0,3,0,3
2023/4/3 0:50,1,17,1,0,0,2,2
2023/4/3 1:00,1,17,1,0,0,1,1
2023/4/3 1:10,1,17,1,0,1,1,2
2023/4/3 1:20,1,17,1,0,0,1,1
2023/4/3 1:30,1,16,1,0,0,0,0
2023/4/3 1:40,1,16,1,0,2,1,3
2023/4/3 1:50,1,16,1,0,2,2,4
2023/4/3 2:00,1,16,1,0,0,0,0
2023/4/3 2:10,1,16,1,0,1,2,3
2023/4/3 2:20,1,16,1,0,1,0,1
2023/4/3 2:30,1,15,1,0,1,1,2
2023/4/3 2:40,1,15,1,0,1,1,2
2023/4/3 2:50,1,15,1,0,0,2,2
2023/4/3 3:00,1,15,1,0,1,0,1
2023/4/3 3:10,1,15,1,0,2,0,2
2023/4/3 3:20,1,15,1,0,2,2,4
2023/4/3 3:30,1,15,1,0,2,1,3
2023/4/3 3:40,0,15,1,0,0,0,0
2023/4/3 3:50,0,15,1,0,0,0,0
2023/4/3 4:00,0,15,1,0,0,0,0
2023/4/3 4:10,0,15,1,0,0,0,0
2023/4/3 4:20,0,15,1,0,0,0,0
2023/4/3 4:30,0,16,1,0,0,0,0
2023/4/3 4:40,0,16,1,0,0,0,0
2023/4/3 4:50,0,16,1,0,0,0,0
2023/4/3 5:00,0,16,1,0,0,0,0
2023/4/3 5:10,0,17,1,0,0,0,0
2023/4/3 5:20,0,17,1,0,0,0,0
2023/4/3 5:30,0,17,1,0,0,0,0
2023/4/3 5:40,0,17,1,0,0,0,0
2023/4/3 5:50,0,17,1,0,1,0,1
2023/4/3 6:00,0,17,1,0,0,1,1
2023/4/3 6:10,0,17,1,0,1,1,2
2023/4/3 6:20,0,18,1,0,1,0,1
2023/4/3 6:30,0,19,1,0,1,0,1
2023/4/3 6:40,0,19,1,0,2,0,2
2023/4/3 6:50,0,20,1,0,7,0,7
2023/4/3 7:00,0,20,1,0,11,1,12
2023/4/3 7:10,0,20,1,0,20,0,20
2023/4/3 7:20,0,20,1,0,20,0,20
2023/4/3 7:30,0,20,1,0,67,0,67
2023/4/3 7:40,0,20,1,0,113,1,114
2023/4/3 7:50,0,20,1,0,122,1,123
2023/4/3 8:00,0,21,1,0,63,2,65
2023/4/3 8:10,0,21,1,0,26,2,28
2023/4/3 8:20,0,21,1,0,21,2,23
2023/4/3 8:30,0,21,1,0,16,3,19
2023/4/3 8:40,0,21,1,0,17,3,20
2023/4/3 8:50,0,21,1,0,15,2,17
2023/4/3 9:00,0,22,1,0,15,3,18
2023/4/3 9:10,0,22,1,0,17,3,20
2023/4/3 9:20,0,22,1,0,33,5,38
2023/4/3 9:30,0,22,1,0,40,8,48
2023/4/3 9:40,0,22,1,0,52,23,75
2023/4/3 9:50,0,22,1,0,39,35,74
2023/4/3 10:00,0,22,1,0,29,32,61
2023/4/3 10:10,0,22,1,0,18,19,37
2023/4/3 10:20,0,22,1,0,13,13,26
2023/4/3 10:30,0,23,1,0,11,11,22
2023/4/3 10:40,0,23,1,0,12,8,20
2023/4/3 10:50,0,23,1,0,12,8,20
2023/4/3 11:00,0,23,1,0,12,8,20
2023/4/3 11:10,0,23,1,0,12,7,19
2023/4/3 11:20,0,23,1,0,13,9,22
2023/4/3 11:30,0,23,1,0,15,13,28
2023/4/3 11:40,0,24,1,0,16,48,64
2023/4/3 11:50,0,24,1,0,14,53,67
2023/4/3 12:00,0,24,1,0,12,50,62
2023/4/3 12:10,0,24,1,0,11,32,43
2023/4/3 12:20,0,25,1,0,13,23,36
2023/4/3 12:30,0,25,1,0,13,16,29
2023/4/3 12:40,0,25,1,0,10,13,23
2023/4/3 12:50,0,26,1,0,13,9,22
2023/4/3 13:00,0,26,1,0,13,6,19
2023/4/3 13:10,0,26,1,0,13,7,20
2023/4/3 13:20,0,26,1,0,19,6,25
2023/4/3 13:30,0,26,1,0,30,6,36
2023/4/3 13:40,0,27,1,0,47,6,53
2023/4/3 13:50,0,27,1,0,45,7,52
2023/4/3 14:00,0,27,1,0,23,5,28
2023/4/3 14:10,0,27,1,0,22,9,31
2023/4/3 14:20,0,27,1,0,20,8,28
2023/4/3 14:30,0,27,1,0,19,9,28
2023/4/3 14:40,0,27,1,0,16,9,25
2023/4/3 14:50,0,27,1,0,13,9,22
2023/4/3 15:00,0,27,1,0,13,9,22
2023/4/3 15:10,0,27,1,0,16,7,23
2023/4/3 15:20,0,27,1,0,16,9,25
2023/4/3 15:30,0,26,1,0,15,15,30
2023/4/3 15:40,0,26,1,0,28,34,62
2023/4/3 15:50,0,26,1,0,28,42,70
2023/4/3 16:00,0,26,1,0,22,32,54
2023/4/3 16:10,0,26,1,0,16,21,37
2023/4/3 16:20,0,26,1,0,14,17,31
2023/4/3 16:30,0,25,1,0,15,15,30
2023/4/3 16:40,0,25,1,0,13,11,24
2023/4/3 16:50,0,25,1,0,13,12,25
2023/4/3 17:00,0,25,1,0,14,10,24
2023/4/3 17:10,0,25,1,0,14,10,24
2023/4/3 17:20,0,24,1,0,14,10,24
2023/4/3 17:30,0,24,1,0,17,19,36
2023/4/3 17:40,1,24,1,0,80,226,306
2023/4/3 17:50,1,24,1,0,88,279,367
2023/4/3 18:00,1,24,1,0,104,218,322
2023/4/3 18:10,1,24,1,0,84,149,233
2023/4/3 18:20,1,24,1,0,84,90,174
2023/4/3 18:30,1,24,1,0,101,96,197
2023/4/3 18:40,1,23,1,0,175,64,239
2023/4/3 18:50,1,23,1,0,148,75,223
2023/4/3 19:00,1,23,1,0,146,56,202
2023/4/3 19:10,1,23,1,0,124,67,191
2023/4/3 19:20,1,23,1,0,109,63,172
2023/4/3 19:30,1,23,1,0,96,57,153
2023/4/3 19:40,1,23,1,0,96,57,153
2023/4/3 19:50,1,23,1,0,84,66,150
2023/4/3 20:00,1,22,1,0,76,72,148
2023/4/3 20:10,1,22,1,0,82,66,148
2023/4/3 20:20,1,22,1,0,74,68,142
2023/4/3 20:30,1,22,1,0,71,100,171
2023/4/3 20:40,1,21,1,0,58,176,234
2023/4/3 20:50,1,21,1,0,55,237,292
2023/4/3 21:00,1,20,1,0,49,143,192
2023/4/3 21:10,1,20,1,0,55,133,188
2023/4/3 21:20,1,20,1,0,30,120,150
2023/4/3 21:30,1,20,1,0,25,69,94
2023/4/3 21:40,1,20,1,0,17,80,97
2023/4/3 21:50,1,20,1,0,20,88,108
2023/4/3 22:00,1,20,1,0,14,94,108
2023/4/3 22:10,1,19,1,0,16,68,84
2023/4/3 22:20,1,19,1,0,18,51,69
2023/4/3 22:30,1,19,1,0,15,32,47
2023/4/3 22:40,1,18,1,0,11,23,34
2023/4/3 22:50,1,18,1,0,10,12,22
2023/4/3 23:00,1,18,1,0,11,13,24
2023/4/3 23:10,1,18,1,0,7,14,21
2023/4/3 23:20,1,18,1,0,6,10,16
2023/4/3 23:30,1,18,1,0,3,10,13
2023/4/3 23:40,1,18,1,0,1,10,11
2023/4/3 23:50,1,17,1,0,1,3,4
2023/4/4 0:00,1,17,1,0,3,1,4
2023/4/4 0:10,1,17,1,0,2,2,4
2023/4/4 0:20,1,17,1,0,2,3,5
2023/4/4 0:30,1,17,1,0,1,2,3
2023/4/4 0:40,1,16,1,0,2,1,3
2023/4/4 0:50,1,16,1,0,2,1,3
2023/4/4 1:00,1,16,1,0,1,1,2
2023/4/4 1:10,1,16,1,0,1,0,1
2023/4/4 1:20,1,15,1,0,2,2,4
2023/4/4 1:30,1,15,1,0,1,0,1
2023/4/4 1:40,1,15,1,0,2,0,2
2023/4/4 1:50,1,15,1,0,0,2,2
2023/4/4 2:00,1,15,1,0,1,2,3
2023/4/4 2:10,1,14,1,0,2,1,3
2023/4/4 2:20,1,14,1,0,1,1,2
2023/4/4 2:30,1,14,1,0,0,0,0
2023/4/4 2:40,1,12,1,0,0,0,0
2023/4/4 2:50,1,12,1,0,1,1,2
2023/4/4 3:00,1,12,1,0,1,1,2
2023/4/4 3:10,1,12,1,0,1,1,2
2023/4/4 3:20,1,12,1,0,2,1,3
2023/4/4 3:30,1,12,1,0,1,1,2
2023/4/4 3:40,1,12,1,0,2,2,4
2023/4/4 3:50,1,12,1,0,1,0,1
2023/4/4 4:00,1,12,1,0,2,2,4
2023/4/4 4:10,1,12,1,0,2,2,4
2023/4/4 4:20,1,12,1,0,2,1,3
2023/4/4 4:30,1,12,1,0,1,0,1
2023/4/4 4:40,1,12,1,0,0,0,0
2023/4/4 4:50,1,12,1,0,2,1,3
2023/4/4 5:00,1,12,1,0,1,2,3
2023/4/4 5:10,1,12,1,0,0,2,2
2023/4/4 5:20,1,12,1,0,2,1,3
2023/4/4 5:30,1,12,1,0,3,1,4
2023/4/4 5:40,1,12,1,0,1,0,1
2023/4/4 5:50,1,12,1,0,4,1,5
2023/4/4 6:00,1,12,1,0,2,4,6
2023/4/4 6:10,1,13,1,0,2,1,3
2023/4/4 6:20,1,13,1,0,6,1,7
2023/4/4 6:30,1,13,1,0,5,2,7
2023/4/4 6:40,1,13,1,0,14,1,15
2023/4/4 6:50,1,13,1,0,39,2,41
2023/4/4 7:00,1,13,1,0,60,3,63
2023/4/4 7:10,1,13,1,0,103,2,105
2023/4/4 7:20,1,13,1,0,123,3,126
2023/4/4 7:30,1,13,1,0,298,1,299
2023/4/4 7:40,1,13,1,0,607,3,610
2023/4/4 7:50,1,13,1,0,596,4,600
2023/4/4 8:00,1,13,1,0,314,7,321
2023/4/4 8:10,1,13,1,0,152,11,163
2023/4/4 8:20,1,13,1,0,87,10,97
2023/4/4 8:30,1,13,1,0,78,14,92
2023/4/4 8:40,1,13,1,0,70,14,84
2023/4/4 8:50,1,13,1,0,66,12,78
2023/4/4 9:00,1,13,1,0,74,14,88
2023/4/4 9:10,1,13,1,0,87,15,102
2023/4/4 9:20,1,13,1,0,145,32,177
2023/4/4 9:30,1,13,1,0,225,40,265
2023/4/4 9:40,1,13,1,0,270,122,392
2023/4/4 9:50,1,13,1,0,194,164,358
2023/4/4 10:00,1,13,1,0,134,145,279
2023/4/4 10:10,1,13,1,0,90,101,191
2023/4/4 10:20,1,13,1,0,76,79,155
2023/4/4 10:30,1,13,1,0,63,45,108
2023/4/4 10:40,1,14,1,0,66,45,111
2023/4/4 10:50,1,14,1,0,70,40,110
2023/4/4 11:00,1,14,1,0,74,36,110
2023/4/4 11:10,1,14,1,0,56,42,98
2023/4/4 11:20,1,14,1,0,61,49,110
2023/4/4 11:30,1,14,1,0,69,70,139
2023/4/4 11:40,1,14,1,0,81,200,281
2023/4/4 11:50,1,14,1,0,68,296,364
2023/4/4 12:00,1,14,1,0,63,226,289
2023/4/4 12:10,1,14,1,0,53,174,227
2023/4/4 12:20,1,14,1,0,63,114,177
2023/4/4 12:30,1,14,1,0,56,84,140
2023/4/4 12:40,1,14,1,0,62,62,124
2023/4/4 12:50,1,14,1,0,55,47,102
2023/4/4 13:00,1,14,1,0,63,33,96
2023/4/4 13:10,1,15,1,0,62,35,97
2023/4/4 13:20,1,15,1,0,84,32,116
2023/4/4 13:30,1,15,1,0,165,32,197
2023/4/4 13:40,1,15,1,0,247,35,282
2023/4/4 13:50,1,15,1,0,238,33,271
2023/4/4 14:00,1,15,1,0,119,30,149
2023/4/4 14:10,1,15,1,0,121,40,161
2023/4/4 14:20,1,15,1,0,91,38,129
2023/4/4 14:30,1,15,1,0,93,43,136
2023/4/4 14:40,1,15,1,0,70,49,119
2023/4/4 14:50,1,15,1,0,65,38,103
2023/4/4 15:00,1,15,1,0,79,39,118
2023/4/4 15:10,1,15,1,0,73,43,116
2023/4/4 15:20,1,15,1,0,71,40,111
2023/4/4 15:30,1,15,1,0,88,71,159
2023/4/4 15:40,1,15,1,0,126,192,318
2023/4/4 15:50,1,15,1,0,173,241,414
2023/4/4 16:00,1,15,1,0,92,128,220
2023/4/4 16:10,1,15,1,0,82,110,192
2023/4/4 16:20,1,15,1,0,69,85,154
2023/4/4 16:30,1,15,1,0,72,62,134
2023/4/4 16:40,1,15,1,0,75,59,134
2023/4/4 16:50,1,15,1,0,80,65,145
2023/4/4 17:00,1,15,1,0,66,62,128
2023/4/4 17:10,1,15,1,0,63,50,113
2023/4/4 17:20,1,15,1,0,81,51,132
2023/4/4 17:30,1,15,1,0,82,85,167
2023/4/4 17:40,1,15,1,0,89,281,370
2023/4/4 17:50,1,15,1,0,92,222,314
2023/4/4 18:00,1,15,1,0,99,188,287
2023/4/4 18:10,1,15,1,0,82,143,225
2023/4/4 18:20,1,15,1,0,106,101,207
2023/4/4 18:30,1,15,1,0,122,98,220
2023/4/4 18:40,1,15,1,0,156,67,223
2023/4/4 18:50,1,15,1,0,155,76,231
2023/4/4 19:00,1,15,1,0,145,58,203
2023/4/4 19:10,1,15,1,0,133,65,198
2023/4/4 19:20,1,15,1,0,99,59,158
2023/4/4 19:30,1,15,1,0,86,66,152
2023/4/4 19:40,1,15,1,0,93,53,146
2023/4/4 19:50,1,15,1,0,73,66,139
2023/4/4 20:00,1,14,1,0,80,69,149
2023/4/4 20:10,1,14,1,0,73,56,129
2023/4/4 20:20,1,14,1,0,75,62,137
2023/4/4 20:30,1,14,1,0,58,88,146
2023/4/4 20:40,1,14,1,0,73,174,247
2023/4/4 20:50,1,14,1,0,52,231,283
2023/4/4 21:00,1,14,1,0,53,158,211
2023/4/4 21:10,1,14,1,0,51,138,189
2023/4/4 21:20,1,14,1,0,28,98,126
2023/4/4 21:30,1,14,1,0,25,62,87
2023/4/4 21:40,1,14,1,0,20,75,95
2023/4/4 21:50,1,14,1,0,20,81,101
2023/4/4 22:00,1,14,1,0,15,83,98
2023/4/4 22:10,1,14,1,0,14,66,80
2023/4/4 22:20,1,14,1,0,16,51,67
2023/4/4 22:30,1,14,1,0,15,31,46
2023/4/4 22:40,1,14,1,0,9,21,30
2023/4/4 22:50,1,14,1,0,9,11,20
2023/4/4 23:00,1,13,1,0,11,10,21
2023/4/4 23:10,1,13,1,0,7,13,20
2023/4/4 23:20,1,13,1,0,5,11,16
2023/4/4 23:30,1,13,1,0,2,7,9
2023/4/4 23:40,1,13,1,0,2,11,13
2023/4/4 23:50,1,13,1,0,0,4,4
2023/4/5 0:00,1,13,0,1,3,3,6
2023/4/5 0:10,1,13,0,1,0,2,2
2023/4/5 0:20,1,13,0,1,1,2,3
2023/4/5 0:30,1,13,0,1,2,0,2
2023/4/5 0:40,1,13,0,1,1,0,1
2023/4/5 0:50,1,13,0,1,1,0,1
2023/4/5 1:00,1,13,0,1,1,2,3
2023/4/5 1:10,1,13,0,1,2,2,4
2023/4/5 1:20,1,13,0,1,2,1,3
2023/4/5 1:30,1,13,0,1,1,1,2
2023/4/5 1:40,1,13,0,1,1,2,3
2023/4/5 1:50,1,12,0,1,0,1,1
2023/4/5 2:00,1,12,0,1,1,0,1
2023/4/5 2:10,1,12,0,1,0,1,1
2023/4/5 2:20,1,12,0,1,0,1,1
2023/4/5 2:30,1,12,0,1,1,1,2
2023/4/5 2:40,1,12,0,1,2,2,4
2023/4/5 2:50,1,12,0,1,2,0,2
2023/4/5 3:00,1,12,0,1,0,0,0
2023/4/5 3:10,1,12,0,1,1,1,2
2023/4/5 3:20,1,12,0,1,1,0,1
2023/4/5 3:30,1,12,0,1,2,0,2
2023/4/5 3:40,1,12,0,1,2,0,2
2023/4/5 3:50,1,12,0,1,0,1,1
2023/4/5 4:00,1,12,0,1,0,0,0
2023/4/5 4:10,1,12,0,1,1,1,2
2023/4/5 4:20,1,12,0,1,0,2,2
2023/4/5 4:30,1,12,0,1,1,1,2
2023/4/5 4:40,1,12,0,1,2,2,4
2023/4/5 4:50,1,12,0,1,1,1,2
2023/4/5 5:00,1,12,0,1,1,0,1
2023/4/5 5:10,1,12,0,1,2,2,4
2023/4/5 5:20,1,12,0,1,3,2,5
2023/4/5 5:30,1,12,0,1,1,0,1
2023/4/5 5:40,1,13,0,1,2,1,3
2023/4/5 5:50,1,13,0,1,2,1,3
2023/4/5 6:00,1,13,0,1,4,0,4
2023/4/5 6:10,1,13,0,1,9,2,11
2023/4/5 6:20,1,13,0,1,8,1,9
2023/4/5 6:30,1,13,0,1,11,4,15
2023/4/5 6:40,1,13,0,1,13,2,15
2023/4/5 6:50,1,13,0,1,10,4,14
2023/4/5 7:00,1,13,0,1,16,2,18
2023/4/5 7:10,1,14,0,1,22,3,25
2023/4/5 7:20,1,14,0,1,44,3,47
2023/4/5 7:30,1,14,0,1,49,4,53
2023/4/5 7:40,1,14,0,1,64,4,68
2023/4/5 7:50,1,14,0,1,53,3,56
2023/4/5 8:00,1,14,0,1,47,5,52
2023/4/5 8:10,1,14,0,1,41,2,43
2023/4/5 8:20,1,14,0,1,28,0,28
2023/4/5 8:30,1,14,0,1,31,1,32
2023/4/5 8:40,1,14,0,1,28,5,33
2023/4/5 8:50,1,14,0,1,34,5,39
2023/4/5 9:00,1,14,0,1,27,2,29
2023/4/5 9:10,1,14,0,1,37,5,42
2023/4/5 9:20,1,14,0,1,30,5,35
2023/4/5 9:30,1,15,0,1,34,12,46
2023/4/5 9:40,1,15,0,1,33,16,49
2023/4/5 9:50,1,15,0,1,39,11,50
2023/4/5 10:00,1,15,0,1,35,16,51
2023/4/5 10:10,1,15,0,1,23,10,33
2023/4/5 10:20,1,15,0,1,19,11,30
2023/4/5 10:30,1,15,0,1,21,13,34
2023/4/5 10:40,1,15,0,1,19,14,33
2023/4/5 10:50,1,16,0,1,21,18,39
2023/4/5 11:00,1,16,0,1,17,20,37
2023/4/5 11:10,1,16,0,1,15,19,34
2023/4/5 11:20,1,16,0,1,10,17,27
2023/4/5 11:30,1,16,0,1,13,20,33
2023/4/5 11:40,1,16,0,1,12,26,38
2023/4/5 11:50,1,16,0,1,11,33,44
2023/4/5 12:00,1,16,0,1,9,30,39
2023/4/5 12:10,1,16,0,1,12,33,45
2023/4/5 12:20,1,16,0,1,11,30,41
2023/4/5 12:30,1,16,0,1,13,26,39
2023/4/5 12:40,1,16,0,1,10,34,44
2023/4/5 12:50,1,16,0,1,10,24,34
2023/4/5 13:00,1,16,0,1,8,20,28
2023/4/5 13:10,1,16,0,1,10,19,29
2023/4/5 13:20,1,16,0,1,17,14,31
2023/4/5 13:30,1,16,0,1,14,16,30
2023/4/5 13:40,1,16,0,1,23,20,43
2023/4/5 13:50,1,16,0,1,21,22,43
2023/4/5 14:00,1,16,0,1,23,18,41
2023/4/5 14:10,1,16,0,1,15,21,36
2023/4/5 14:20,1,15,0,1,16,15,31
2023/4/5 14:30,1,15,0,1,13,18,31
2023/4/5 14:40,1,15,0,1,17,12,29
2023/4/5 14:50,1,15,0,1,16,12,28
2023/4/5 15:00,1,15,0,1,23,12,35
2023/4/5 15:10,1,15,0,1,27,11,38
2023/4/5 15:20,1,15,0,1,25,13,38
2023/4/5 15:30,1,15,0,1,29,18,47
2023/4/5 15:40,1,15,0,1,21,18,39
2023/4/5 15:50,1,14,0,1,31,17,48
2023/4/5 16:00,1,14,0,1,27,15,42
2023/4/5 16:10,1,14,0,1,26,18,44
2023/4/5 16:20,1,14,0,1,26,11,37
2023/4/5 16:30,1,14,0,1,33,11,44
2023/4/5 16:40,1,14,0,1,26,9,35
2023/4/5 16:50,1,14,0,1,34,16,50
2023/4/5 17:00,1,14,0,1,32,19,51
2023/4/5 17:10,1,13,0,1,32,20,52
2023/4/5 17:20,1,13,0,1,39,23,62
2023/4/5 17:30,1,13,0,1,31,24,55
2023/4/5 17:40,1,13,0,1,36,28,64
2023/4/5 17:50,1,13,0,1,40,37,77
2023/4/5 18:00,1,13,0,1,42,35,77
2023/4/5 18:10,1,13,0,1,40,26,66
2023/4/5 18:20,1,13,0,1,44,26,70
2023/4/5 18:30,1,13,0,1,38,31,69
2023/4/5 18:40,1,13,0,1,36,22,58
2023/4/5 18:50,1,12,0,1,34,27,61
2023/4/5 19:00,1,12,0,1,29,20,49
2023/4/5 19:10,1,12,0,1,29,19,48
2023/4/5 19:20,1,12,0,1,24,18,42
2023/4/5 19:30,1,12,0,1,22,20,42
2023/4/5 19:40,1,12,0,1,28,21,49
2023/4/5 19:50,1,12,0,1,21,17,38
2023/4/5 20:00,1,12,0,1,25,19,44
2023/4/5 20:10,1,12,0,1,18,18,36
2023/4/5 20:20,1,12,0,1,18,25,43
2023/4/5 20:30,1,12,0,1,16,32,48
2023/4/5 20:40,1,11,0,1,16,32,48
2023/4/5 20:50,1,11,0,1,15,27,42
2023/4/5 21:00,1,11,0,1,12,35,47
2023/4/5 21:10,1,11,0,1,17,23,40
2023/4/5 21:20,1,11,0,1,10,21,31
2023/4/5 21:30,1,11,0,1,8,24,32
2023/4/5 21:40,1,10,0,1,9,35,44
2023/4/5 21:50,1,10,0,1,10,36,46
2023/4/5 22:00,1,10,0,1,4,38,42
2023/4/5 22:10,1,10,0,1,3,36,39
2023/4/5 22:20,1,10,0,1,2,28,30
2023/4/5 22:30,1,10,0,1,3,19,22
2023/4/5 22:40,1,10,0,1,3,11,14
2023/4/5 22:50,1,10,0,1,2,11,13
2023/4/5 23:00,1,10,0,1,3,5,8
2023/4/5 23:10,1,10,0,1,1,6,7
2023/4/5 23:20,1,9,0,1,1,3,4
2023/4/5 23:30,1,9,0,1,2,2,4
2023/4/5 23:40,1,9,0,1,0,2,2
2023/4/5 23:50,1,9,0,1,0,0,0
2023/4/6 0:00,1,9,1,0,3,0,3
2023/4/6 0:10,1,9,1,0,2,2,4
2023/4/6 0:20,1,9,1,0,2,2,4
2023/4/6 0:30,1,9,1,0,1,1,2
2023/4/6 0:40,1,9,1,0,2,1,3
2023/4/6 0:50,1,9,1,0,2,2,4
2023/4/6 1:00,1,9,1,0,2,0,2
2023/4/6 1:10,1,9,1,0,2,1,3
2023/4/6 1:20,1,9,1,0,0,2,2
2023/4/6 1:30,1,9,1,0,1,0,1
2023/4/6 1:40,1,9,1,0,2,0,2
2023/4/6 1:50,1,9,1,0,0,0,0
2023/4/6 2:00,1,8,1,0,0,1,1
2023/4/6 2:10,1,8,1,0,0,1,1
2023/4/6 2:20,1,8,1,0,2,0,2
2023/4/6 2:30,1,8,1,0,1,0,1
2023/4/6 2:40,1,8,1,0,2,2,4
2023/4/6 2:50,1,8,1,0,2,0,2
2023/4/6 3:00,1,8,1,0,2,2,4
2023/4/6 3:10,1,8,1,0,2,2,4
2023/4/6 3:20,1,8,1,0,1,0,1
2023/4/6 3:30,1,8,1,0,1,0,1
2023/4/6 3:40,1,8,1,0,1,1,2
2023/4/6 3:50,1,8,1,0,1,1,2
2023/4/6 4:00,1,8,1,0,1,2,3
2023/4/6 4:10,1,8,1,0,0,1,1
2023/4/6 4:20,1,8,1,0,1,2,3
2023/4/6 4:30,1,8,1,0,2,1,3
2023/4/6 4:40,1,8,1,0,2,0,2
2023/4/6 4:50,1,8,1,0,2,0,2
2023/4/6 5:00,1,8,1,0,2,2,4
2023/4/6 5:10,1,8,1,0,0,0,0
2023/4/6 5:20,1,8,1,0,0,0,0
2023/4/6 5:30,1,8,1,0,2,2,4
2023/4/6 5:40,1,8,1,0,0,0,0
2023/4/6 5:50,1,9,1,0,5,2,7
2023/4/6 6:00,1,9,1,0,3,2,5
2023/4/6 6:10,1,9,1,0,2,1,3
2023/4/6 6:20,1,9,1,0,4,1,5
2023/4/6 6:30,1,9,1,0,6,4,10
2023/4/6 6:40,1,9,1,0,11,0,11
2023/4/6 6:50,1,9,1,0,33,0,33
2023/4/6 7:00,1,9,1,0,66,2,68
2023/4/6 7:10,1,9,1,0,103,1,104
2023/4/6 7:20,1,9,1,0,106,1,107
2023/4/6 7:30,1,10,1,0,334,2,336
2023/4/6 7:40,1,10,1,0,590,4,594
2023/4/6 7:50,1,10,1,0,577,4,581
2023/4/6 8:00,1,10,1,0,280,5,285
2023/4/6 8:10,1,10,1,0,146,10,156
2023/4/6 8:20,1,10,1,0,101,9,110
2023/4/6 8:30,1,10,1,0,73,14,87
2023/4/6 8:40,1,10,1,0,69,13,82
2023/4/6 8:50,1,10,1,0,83,14,97
2023/4/6 9:00,1,10,1,0,80,14,94
2023/4/6 9:10,1,10,1,0,82,20,102
2023/4/6 9:20,1,11,1,0,137,27,164
2023/4/6 9:30,1,11,1,0,221,42,263
2023/4/6 9:40,1,11,1,0,226,113,339
2023/4/6 9:50,1,11,1,0,178,172,350
2023/4/6 10:00,1,11,1,0,145,167,312
2023/4/6 10:10,1,11,1,0,83,92,175
2023/4/6 10:20,1,11,1,0,86,77,163
2023/4/6 10:30,1,11,1,0,64,48,112
2023/4/6 10:40,1,11,1,0,64,49,113
2023/4/6 10:50,1,12,1,0,63,36,99
2023/4/6 11:00,1,12,1,0,75,39,114
2023/4/6 11:10,1,12,1,0,56,43,99
2023/4/6 11:20,1,12,1,0,64,49,113
2023/4/6 11:30,1,12,1,0,75,70,145
2023/4/6 11:40,1,12,1,0,83,235,318
2023/4/6 11:50,1,12,1,0,69,311,380
2023/4/6 12:00,1,13,1,0,60,291,351
2023/4/6 12:10,1,13,1,0,53,171,224
2023/4/6 12:20,1,13,1,0,66,118,184
2023/4/6 12:30,1,13,1,0,71,78,149
2023/4/6 12:40,1,13,1,0,59,58,117
2023/4/6 12:50,1,13,1,0,57,51,108
2023/4/6 13:00,1,13,1,0,63,28,91
2023/4/6 13:10,1,14,1,0,66,34,100
2023/4/6 13:20,1,14,1,0,89,36,125
2023/4/6 13:30,1,14,1,0,156,38,194
2023/4/6 13:40,1,14,1,0,233,33,266
2023/4/6 13:50,1,14,1,0,258,37,295
2023/4/6 14:00,1,14,1,0,128,27,155
2023/4/6 14:10,1,14,1,0,102,37,139
2023/4/6 14:20,1,15,1,0,91,34,125
2023/4/6 14:30,1,15,1,0,88,44,132
2023/4/6 14:40,1,15,1,0,81,39,120
2023/4/6 14:50,1,15,1,0,62,38,100
2023/4/6 15:00,1,15,1,0,63,46,109
2023/4/6 15:10,1,15,1,0,67,46,113
2023/4/6 15:20,1,15,1,0,67,37,104
2023/4/6 15:30,1,15,1,0,90,61,151
2023/4/6 15:40,1,15,1,0,146,194,340
2023/4/6 15:50,1,15,1,0,141,241,382
2023/4/6 16:00,1,15,1,0,105,130,235
2023/4/6 16:10,1,15,1,0,89,118,207
2023/4/6 16:20,1,16,1,0,80,90,170
2023/4/6 16:30,1,16,1,0,72,64,136
2023/4/6 16:40,1,16,1,0,76,58,134
2023/4/6 16:50,1,16,1,0,77,69,146
2023/4/6 17:00,1,16,1,0,81,53,134
2023/4/6 17:10,1,16,1,0,76,51,127
2023/4/6 17:20,1,16,1,0,77,58,135
2023/4/6 17:30,1,16,1,0,85,75,160
2023/4/6 17:40,1,16,1,0,82,243,325
2023/4/6 17:50,1,16,1,0,94,256,350
2023/4/6 18:00,1,16,1,0,81,206,287
2023/4/6 18:10,1,16,1,0,87,128,215
2023/4/6 18:20,1,16,1,0,91,104,195
2023/4/6 18:30,1,16,1,0,120,86,206
2023/4/6 18:40,1,16,1,0,181,68,249
2023/4/6 18:50,1,16,1,0,148,70,218
2023/4/6 19:00,1,16,1,0,126,69,195
2023/4/6 19:10,1,16,1,0,117,68,185
2023/4/6 19:20,1,16,1,0,86,62,148
2023/4/6 19:30,1,16,1,0,95,58,153
2023/4/6 19:40,1,16,1,0,100,59,159
2023/4/6 19:50,1,16,1,0,89,60,149
2023/4/6 20:00,1,16,1,0,77,59,136
2023/4/6 20:10,1,16,1,0,76,56,132
2023/4/6 20:20,1,16,1,0,87,70,157
2023/4/6 20:30,1,15,1,0,65,103,168
2023/4/6 20:40,1,15,1,0,72,175,247
2023/4/6 20:50,1,15,1,0,60,230,290
2023/4/6 21:00,1,15,1,0,43,174,217
2023/4/6 21:10,1,15,1,0,46,117,163
2023/4/6 21:20,1,15,1,0,29,98,127
2023/4/6 21:30,1,15,1,0,21,63,84
2023/4/6 21:40,1,15,1,0,20,73,93
2023/4/6 21:50,1,15,1,0,17,83,100
2023/4/6 22:00,1,14,1,0,16,78,94
2023/4/6 22:10,1,14,1,0,17,85,102
2023/4/6 22:20,1,14,1,0,18,45,63
2023/4/6 22:30,1,14,1,0,16,31,47
2023/4/6 22:40,1,14,1,0,9,22,31
2023/4/6 22:50,1,14,1,0,12,15,27
2023/4/6 23:00,1,14,1,0,10,11,21
2023/4/6 23:10,1,14,1,0,5,12,17
2023/4/6 23:20,1,14,1,0,6,10,16
2023/4/6 23:30,1,14,1,0,3,8,11
2023/4/6 23:40,1,14,1,0,2,10,12
2023/4/6 23:50,1,14,1,0,0,4,4
2023/4/7 0:00,1,14,1,0,5,2,7
2023/4/7 0:10,1,14,1,0,2,1,3
2023/4/7 0:20,1,14,1,0,2,3,5
2023/4/7 0:30,1,13,1,0,0,0,0
2023/4/7 0:40,1,13,1,0,3,1,4
2023/4/7 0:50,1,13,1,0,1,1,2
2023/4/7 1:00,1,13,1,0,0,0,0
2023/4/7 1:10,1,13,1,0,0,0,0
2023/4/7 1:20,1,13,1,0,2,0,2
2023/4/7 1:30,1,13,1,0,0,0,0
2023/4/7 1:40,1,13,1,0,2,0,2
2023/4/7 1:50,1,13,1,0,0,2,2
2023/4/7 2:00,1,13,1,0,1,0,1
2023/4/7 2:10,1,12,1,0,2,1,3
2023/4/7 2:20,1,12,1,0,0,0,0
2023/4/7 2:30,1,12,1,0,0,2,2
2023/4/7 2:40,1,12,1,0,0,2,2
2023/4/7 2:50,1,12,1,0,1,0,1
2023/4/7 3:00,1,12,1,0,2,2,4
2023/4/7 3:10,1,12,1,0,2,2,4
2023/4/7 3:20,1,12,1,0,0,0,0
2023/4/7 3:30,1,12,1,0,1,0,1
2023/4/7 3:40,1,12,1,0,2,0,2
2023/4/7 3:50,1,12,1,0,0,1,1
2023/4/7 4:00,1,12,1,0,0,2,2
2023/4/7 4:10,1,12,1,0,1,1,2
2023/4/7 4:20,1,12,1,0,2,2,4
2023/4/7 4:30,1,12,1,0,1,1,2
2023/4/7 4:40,1,12,1,0,0,0,0
2023/4/7 4:50,1,12,1,0,2,0,2
2023/4/7 5:00,1,13,1,0,2,2,4
2023/4/7 5:10,1,13,1,0,1,0,1
2023/4/7 5:20,1,13,1,0,0,0,0
2023/4/7 5:30,1,13,1,0,1,0,1
2023/4/7 5:40,1,13,1,0,2,1,3
2023/4/7 5:50,1,13,1,0,3,2,5
2023/4/7 6:00,1,14,1,0,4,3,7
2023/4/7 6:10,1,14,1,0,2,3,5
2023/4/7 6:20,1,15,1,0,4,2,6
2023/4/7 6:30,1,15,1,0,7,2,9
2023/4/7 6:40,1,15,1,0,12,0,12
2023/4/7 6:50,1,15,1,0,36,1,37
2023/4/7 7:00,1,15,1,0,66,4,70
2023/4/7 7:10,1,15,1,0,100,2,102
2023/4/7 7:20,1,15,1,0,105,3,108
2023/4/7 7:30,1,15,1,0,321,0,321
2023/4/7 7:40,1,16,1,0,583,5,588
2023/4/7 7:50,1,16,1,0,647,4,651
2023/4/7 8:00,1,16,1,0,329,6,335
2023/4/7 8:10,1,16,1,0,130,8,138
2023/4/7 8:20,1,16,1,0,107,9,116
2023/4/7 8:30,1,16,1,0,86,14,100
2023/4/7 8:40,1,16,1,0,79,16,95
2023/4/7 8:50,1,17,1,0,65,12,77
2023/4/7 9:00,1,17,1,0,76,16,92
2023/4/7 9:10,1,17,1,0,97,15,112
2023/4/7 9:20,1,17,1,0,141,27,168
2023/4/7 9:30,1,17,1,0,198,37,235
2023/4/7 9:40,1,17,1,0,275,139,414
2023/4/7 9:50,1,18,1,0,201,189,390
2023/4/7 10:00,1,18,1,0,133,167,300
2023/4/7 10:10,1,18,1,0,76,112,188
2023/4/7 10:20,1,18,1,0,68,76,144
2023/4/7 10:30,1,18,1,0,59,56,115
2023/4/7 10:40,1,18,1,0,57,42,99
2023/4/7 10:50,1,18,1,0,61,42,103
2023/4/7 11:00,1,18,1,0,65,39,104
2023/4/7 11:10,1,18,1,0,57,40,97
2023/4/7 11:20,1,19,1,0,54,42,96
2023/4/7 11:30,1,19,1,0,71,68,139
2023/4/7 11:40,1,19,1,0,78,230,308
2023/4/7 11:50,1,20,1,0,66,254,320
2023/4/7 12:00,1,20,1,0,52,230,282
2023/4/7 12:10,1,20,1,0,60,157,217
2023/4/7 12:20,1,20,1,0,63,133,196
2023/4/7 12:30,1,20,1,0,71,92,163
2023/4/7 12:40,1,21,1,0,59,58,117
2023/4/7 12:50,1,21,1,0,61,46,107
2023/4/7 13:00,1,21,1,0,62,29,91
2023/4/7 13:10,1,21,1,0,65,30,95
2023/4/7 13:20,1,21,1,0,77,31,108
2023/4/7 13:30,1,21,1,0,173,37,210
2023/4/7 13:40,1,22,1,0,263,33,296
2023/4/7 13:50,1,22,1,0,236,41,277
2023/4/7 14:00,1,22,1,0,122,34,156
2023/4/7 14:10,1,22,1,0,121,45,166
2023/4/7 14:20,1,22,1,0,97,40,137
2023/4/7 14:30,1,22,1,0,89,44,133
2023/4/7 14:40,1,22,1,0,79,49,128
2023/4/7 14:50,1,22,1,0,68,42,110
2023/4/7 15:00,1,22,1,0,69,51,120
2023/4/7 15:10,1,22,1,0,74,46,120
2023/4/7 15:20,1,22,1,0,74,41,115
2023/4/7 15:30,1,22,1,0,79,70,149
2023/4/7 15:40,1,22,1,0,153,188,341
2023/4/7 15:50,1,22,1,0,140,235,375
2023/4/7 16:00,1,22,1,0,93,164,257
2023/4/7 16:10,1,22,1,0,87,125,212
2023/4/7 16:20,1,21,1,0,83,90,173
2023/4/7 16:30,1,21,1,0,83,63,146
2023/4/7 16:40,1,21,1,0,74,64,138
2023/4/7 16:50,1,21,1,0,64,59,123
2023/4/7 17:00,1,21,1,0,80,52,132
2023/4/7 17:10,1,21,1,0,71,60,131
2023/4/7 17:20,1,20,1,0,82,50,132
2023/4/7 17:30,1,20,1,0,75,75,150
2023/4/7 17:40,1,20,1,0,98,218,316
2023/4/7 17:50,1,20,1,0,101,267,368
2023/4/7 18:00,1,19,1,0,94,201,295
2023/4/7 18:10,1,19,1,0,75,139,214
2023/4/7 18:20,1,19,1,0,102,86,188
2023/4/7 18:30,1,19,1,0,100,91,191
2023/4/7 18:40,1,19,1,0,190,80,270
2023/4/7 18:50,1,19,1,0,190,65,255
2023/4/7 19:00,1,19,1,0,124,71,195
2023/4/7 19:10,1,18,1,0,121,58,179
2023/4/7 19:20,1,18,1,0,93,58,151
2023/4/7 19:30,1,18,1,0,85,66,151
2023/4/7 19:40,1,18,1,0,87,60,147
2023/4/7 19:50,1,18,1,0,85,63,148
2023/4/7 20:00,1,18,1,0,83,66,149
2023/4/7 20:10,1,18,1,0,82,66,148
2023/4/7 20:20,1,18,1,0,82,61,143
2023/4/7 20:30,1,18,1,0,59,88,147
2023/4/7 20:40,1,17,1,0,74,208,282
2023/4/7 20:50,1,17,1,0,59,236,295
2023/4/7 21:00,1,17,1,0,52,164,216
2023/4/7 21:10,1,17,1,0,49,137,186
2023/4/7 21:20,1,17,1,0,32,106,138
2023/4/7 21:30,1,17,1,0,26,64,90
2023/4/7 21:40,1,16,1,0,19,83,102
2023/4/7 21:50,1,16,1,0,16,86,102
2023/4/7 22:00,1,16,1,0,14,91,105
2023/4/7 22:10,1,16,1,0,13,68,81
2023/4/7 22:20,1,16,1,0,18,42,60
2023/4/7 22:30,1,16,1,0,12,31,43
2023/4/7 22:40,1,15,1,0,11,19,30
2023/4/7 22:50,1,15,1,0,9,11,20
2023/4/7 23:00,1,15,1,0,10,10,20
2023/4/7 23:10,1,15,1,0,8,10,18
2023/4/7 23:20,1,15,1,0,7,10,17
2023/4/7 23:30,1,15,1,0,2,8,10
2023/4/7 23:40,1,14,1,0,2,10,12
2023/4/7 23:50,1,14,1,0,2,6,8
2023/4/8 0:00,1,14,0,0,2,3,5
2023/4/8 0:10,1,14,0,0,2,1,3
2023/4/8 0:20,1,14,0,0,2,1,3
2023/4/8 0:30,1,14,0,0,2,2,4
2023/4/8 0:40,1,14,0,0,1,2,3
2023/4/8 0:50,1,14,0,0,0,1,1
2023/4/8 1:00,1,12,0,0,2,0,2
2023/4/8 1:10,1,12,0,0,1,0,1
2023/4/8 1:20,1,12,0,0,2,2,4
2023/4/8 1:30,1,12,0,0,1,0,1
2023/4/8 1:40,1,12,0,0,0,2,2
2023/4/8 1:50,1,12,0,0,0,0,0
2023/4/8 2:00,1,11,0,0,0,2,2
2023/4/8 2:10,1,11,0,0,0,0,0
2023/4/8 2:20,1,11,0,0,0,1,1
2023/4/8 2:30,1,11,0,0,1,2,3
2023/4/8 2:40,1,11,0,0,2,1,3
2023/4/8 2:50,1,11,0,0,2,1,3
2023/4/8 3:00,1,11,0,0,2,2,4
2023/4/8 3:10,1,10,0,0,2,0,2
2023/4/8 3:20,1,10,0,0,0,2,2
2023/4/8 3:30,1,10,0,0,2,2,4
2023/4/8 3:40,1,10,0,0,2,0,2
2023/4/8 3:50,1,10,0,0,2,1,3
2023/4/8 4:00,1,10,0,0,0,1,1
2023/4/8 4:10,1,10,0,0,1,1,2
2023/4/8 4:20,1,10,0,0,2,0,2
2023/4/8 4:30,1,10,0,0,2,2,4
2023/4/8 4:40,1,10,0,0,0,1,1
2023/4/8 4:50,1,10,0,0,2,1,3
2023/4/8 5:00,1,11,0,0,2,2,4
2023/4/8 5:10,1,11,0,0,1,2,3
2023/4/8 5:20,1,11,0,0,1,0,1
2023/4/8 5:30,1,11,0,0,1,0,1
2023/4/8 5:40,1,11,0,0,3,1,4
2023/4/8 5:50,1,12,0,0,2,1,3
2023/4/8 6:00,1,12,0,0,6,1,7
2023/4/8 6:10,1,12,0,0,7,1,8
2023/4/8 6:20,1,12,0,0,6,2,8
2023/4/8 6:30,1,13,0,0,8,3,11
2023/4/8 6:40,1,13,0,0,11,1,12
2023/4/8 6:50,1,13,0,0,11,2,13
2023/4/8 7:00,1,13,0,0,16,1,17
2023/4/8 7:10,1,13,0,0,19,3,22
2023/4/8 7:20,1,14,0,0,43,3,46
2023/4/8 7:30,1,14,0,0,58,4,62
2023/4/8 7:40,1,14,0,0,65,4,69
2023/4/8 7:50,1,14,0,0,50,3,53
2023/4/8 8:00,1,14,0,0,38,4,42
2023/4/8 8:10,1,15,0,0,35,2,37
2023/4/8 8:20,1,15,0,0,28,0,28
2023/4/8 8:30,1,15,0,0,32,1,33
2023/4/8 8:40,1,16,0,0,32,3,35
2023/4/8 8:50,1,16,0,0,34,5,39
2023/4/8 9:00,1,16,0,0,28,3,31
2023/4/8 9:10,1,16,0,0,33,4,37
2023/4/8 9:20,1,17,0,0,37,6,43
2023/4/8 9:30,1,17,0,0,38,12,50
2023/4/8 9:40,1,17,0,0,39,16,55
2023/4/8 9:50,1,17,0,0,38,8,46
2023/4/8 10:00,1,18,0,0,33,14,47
2023/4/8 10:10,1,18,0,0,26,9,35
2023/4/8 10:20,1,18,0,0,24,8,32
2023/4/8 10:30,1,18,0,0,23,12,35
2023/4/8 10:40,1,18,0,0,18,15,33
2023/4/8 10:50,1,18,0,0,17,18,35
2023/4/8 11:00,1,18,0,0,16,18,34
2023/4/8 11:10,1,18,0,0,16,20,36
2023/4/8 11:20,1,19,0,0,14,19,33
2023/4/8 11:30,1,19,0,0,14,22,36
2023/4/8 11:40,1,19,0,0,9,26,35
2023/4/8 11:50,1,19,0,0,14,33,47
2023/4/8 12:00,1,19,0,0,12,37,49
2023/4/8 12:10,1,20,0,0,12,26,38
2023/4/8 12:20,1,20,0,0,11,25,36
2023/4/8 12:30,1,20,0,0,17,26,43
2023/4/8 12:40,1,20,0,0,14,30,44
2023/4/8 12:50,1,20,0,0,8,26,34
2023/4/8 13:00,1,20,0,0,12,22,34
2023/4/8 13:10,1,20,0,0,12,20,32
2023/4/8 13:20,1,20,0,0,17,16,33
2023/4/8 13:30,1,20,0,0,18,13,31
2023/4/8 13:40,1,21,0,0,28,15,43
2023/4/8 13:50,1,21,0,0,23,19,42
2023/4/8 14:00,1,21,0,0,26,18,44
2023/4/8 14:10,1,21,0,0,16,23,39
2023/4/8 14:20,1,21,0,0,15,13,28
2023/4/8 14:30,1,22,0,0,17,17,34
2023/4/8 14:40,1,22,0,0,14,15,29
2023/4/8 14:50,1,22,0,0,20,14,34
2023/4/8 15:00,1,22,0,0,18,12,30
2023/4/8 15:10,1,22,0,0,21,15,36
2023/4/8 15:20,1,22,0,0,25,16,41
2023/4/8 15:30,1,23,0,0,25,14,39
2023/4/8 15:40,1,23,0,0,24,19,43
2023/4/8 15:50,1,23,0,0,25,15,40
2023/4/8 16:00,1,23,0,0,22,15,37
2023/4/8 16:10,1,23,0,0,25,18,43
2023/4/8 16:20,1,23,0,0,25,15,40
2023/4/8 16:30,1,23,0,0,27,10,37
2023/4/8 16:40,1,24,0,0,29,11,40
2023/4/8 16:50,1,24,0,0,35,18,53
2023/4/8 17:00,1,24,0,0,35,18,53
2023/4/8 17:10,1,24,0,0,32,19,51
2023/4/8 17:20,1,24,0,0,39,24,63
2023/4/8 17:30,1,24,0,0,31,25,56
2023/4/8 17:40,1,24,0,0,30,28,58
2023/4/8 17:50,1,24,0,0,40,35,75
2023/4/8 18:00,1,24,0,0,44,34,78
2023/4/8 18:10,1,24,0,0,44,27,71
2023/4/8 18:20,1,24,0,0,40,28,68
2023/4/8 18:30,1,23,0,0,45,28,73
2023/4/8 18:40,1,23,0,0,39,27,66
2023/4/8 18:50,1,23,0,0,36,32,68
2023/4/8 19:00,1,23,0,0,30,23,53
2023/4/8 19:10,1,22,0,0,30,22,52
2023/4/8 19:20,1,22,0,0,21,21,42
2023/4/8 19:30,1,22,0,0,25,18,43
2023/4/8 19:40,1,22,0,0,28,22,50
2023/4/8 19:50,1,22,0,0,21,19,40
2023/4/8 20:00,1,21,0,0,21,24,45
2023/4/8 20:10,1,21,0,0,20,19,39
2023/4/8 20:20,1,21,0,0,18,25,43
2023/4/8 20:30,1,21,0,0,16,31,47
2023/4/8 20:40,1,20,0,0,15,29,44
2023/4/8 20:50,1,20,0,0,14,31,45
2023/4/8 21:00,1,20,0,0,14,31,45
2023/4/8 21:10,1,20,0,0,14,23,37
2023/4/8 21:20,1,20,0,0,9,24,33
2023/4/8 21:30,1,20,0,0,11,23,34
2023/4/8 21:40,1,20,0,0,7,42,49
2023/4/8 21:50,1,20,0,0,10,41,51
2023/4/8 22:00,1,19,0,0,4,39,43
2023/4/8 22:10,1,19,0,0,3,29,32
2023/4/8 22:20,1,19,0,0,3,25,28
2023/4/8 22:30,1,19,0,0,2,16,18
2023/4/8 22:40,1,19,0,0,3,10,13
2023/4/8 22:50,1,18,0,0,2,8,10
2023/4/8 23:00,1,18,0,0,2,6,8
2023/4/8 23:10,1,18,0,0,3,4,7
2023/4/8 23:20,1,18,0,0,0,1,1
2023/4/8 23:30,1,18,0,0,2,2,4
2023/4/8 23:40,1,18,0,0,2,2,4
2023/4/8 23:50,1,17,0,0,0,0,0
2023/4/9 0:00,1,17,0,0,1,3,4
2023/4/9 0:10,1,17,0,0,1,0,1
2023/4/9 0:20,1,17,0,0,0,2,2
2023/4/9 0:30,1,17,0,0,1,2,3
2023/4/9 0:40,1,16,0,0,2,0,2
2023/4/9 0:50,1,16,0,0,2,1,3
2023/4/9 1:00,1,16,0,0,2,2,4
2023/4/9 1:10,1,16,0,0,2,1,3
2023/4/9 1:20,1,16,0,0,1,2,3
2023/4/9 1:30,1,16,0,0,2,1,3
2023/4/9 1:40,1,16,0,0,2,1,3
2023/4/9 1:50,1,15,0,0,2,2,4
2023/4/9 2:00,1,15,0,0,2,1,3
2023/4/9 2:10,1,15,0,0,0,2,2
2023/4/9 2:20,1,15,0,0,2,1,3
2023/4/9 2:30,1,15,0,0,1,0,1
2023/4/9 2:40,1,14,0,0,2,0,2
2023/4/9 2:50,1,14,0,0,0,0,0
2023/4/9 3:00,1,14,0,0,1,2,3
2023/4/9 3:10,1,14,0,0,2,0,2
2023/4/9 3:20,1,14,0,0,2,1,3
2023/4/9 3:30,1,14,0,0,0,1,1
2023/4/9 3:40,1,14,0,0,0,0,0
2023/4/9 3:50,1,14,0,0,0,0,0
2023/4/9 4:00,1,14,0,0,2,2,4
2023/4/9 4:10,1,14,0,0,0,1,1
2023/4/9 4:20,1,14,0,0,1,1,2
2023/4/9 4:30,1,14,0,0,1,1,2
2023/4/9 4:40,1,14,0,0,0,0,0
2023/4/9 4:50,1,14,0,0,1,2,3
2023/4/9 5:00,1,15,0,0,0,0,0
2023/4/9 5:10,1,15,0,0,1,2,3
2023/4/9 5:20,1,15,0,0,2,1,3
2023/4/9 5:30,1,15,0,0,1,2,3
2023/4/9 5:40,1,15,0,0,1,2,3
2023/4/9 5:50,1,15,0,0,4,1,5
2023/4/9 6:00,1,15,0,0,7,2,9
2023/4/9 6:10,1,15,0,0,9,1,10
2023/4/9 6:20,1,15,0,0,5,0,5
2023/4/9 6:30,1,16,0,0,11,3,14
2023/4/9 6:40,1,16,0,0,11,1,12
2023/4/9 6:50,1,16,0,0,9,4,13
2023/4/9 7:00,1,16,0,0,14,1,15
2023/4/9 7:10,1,16,0,0,20,1,21
2023/4/9 7:20,1,16,0,0,36,1,37
2023/4/9 7:30,1,16,0,0,47,5,52
2023/4/9 7:40,1,16,0,0,57,3,60
2023/4/9 7:50,1,16,0,0,55,2,57
2023/4/9 8:00,1,16,0,0,39,3,42
2023/4/9 8:10,1,17,0,0,38,2,40
2023/4/9 8:20,1,17,0,0,28,1,29
2023/4/9 8:30,1,17,0,0,34,2,36
2023/4/9 8:40,1,17,0,0,32,5,37
2023/4/9 8:50,1,18,0,0,36,3,39
2023/4/9 9:00,1,18,0,0,27,2,29
2023/4/9 9:10,1,18,0,0,32,6,38
2023/4/9 9:20,1,19,0,0,30,7,37
2023/4/9 9:30,1,19,0,0,32,15,47
2023/4/9 9:40,1,19,0,0,42,15,57
2023/4/9 9:50,1,19,0,0,40,11,51
2023/4/9 10:00,1,19,0,0,34,14,48
2023/4/9 10:10,1,19,0,0,25,11,36
2023/4/9 10:20,1,19,0,0,21,9,30
2023/4/9 10:30,1,19,0,0,19,14,33
2023/4/9 10:40,1,19,0,0,23,13,36
2023/4/9 10:50,1,19,0,0,19,17,36
2023/4/9 11:00,1,20,0,0,14,19,33
2023/4/9 11:10,1,20,0,0,14,18,32
2023/4/9 11:20,1,20,0,0,11,21,32
2023/4/9 11:30,1,20,0,0,16,19,35
2023/4/9 11:40,1,20,0,0,12,26,38
2023/4/9 11:50,1,20,0,0,13,32,45
2023/4/9 12:00,1,21,0,0,9,35,44
2023/4/9 12:10,1,21,0,0,12,31,43
2023/4/9 12:20,1,21,0,0,14,28,42
2023/4/9 12:30,1,21,0,0,17,31,48
2023/4/9 12:40,1,21,0,0,13,34,47
2023/4/9 12:50,1,21,0,0,10,27,37
2023/4/9 13:00,1,21,0,0,9,21,30
2023/4/9 13:10,1,21,0,0,13,17,30
2023/4/9 13:20,1,21,0,0,13,17,30
2023/4/9 13:30,1,21,0,0,16,16,32
2023/4/9 13:40,1,22,0,0,22,15,37
2023/4/9 13:50,1,22,0,0,21,19,40
2023/4/9 14:00,1,22,0,0,26,17,43
2023/4/9 14:10,1,22,0,0,17,19,36
2023/4/9 14:20,1,22,0,0,18,15,33
2023/4/9 14:30,1,22,0,0,13,14,27
2023/4/9 14:40,1,22,0,0,17,14,31
2023/4/9 14:50,1,22,0,0,17,14,31
2023/4/9 15:00,1,22,0,0,18,11,29
2023/4/9 15:10,1,22,0,0,24,12,36
2023/4/9 15:20,1,23,0,0,22,13,35
2023/4/9 15:30,1,23,0,0,29,15,44
2023/4/9 15:40,1,23,0,0,25,16,41
2023/4/9 15:50,1,23,0,0,28,19,47
2023/4/9 16:00,1,23,0,0,21,13,34
2023/4/9 16:10,1,24,0,0,21,17,38
2023/4/9 16:20,1,24,0,0,22,15,37
2023/4/9 16:30,1,24,0,0,30,12,42
2023/4/9 16:40,1,24,0,0,28,11,39
2023/4/9 16:50,1,24,0,0,34,18,52
2023/4/9 17:00,1,24,0,0,34,15,49
2023/4/9 17:10,1,24,0,0,28,23,51
2023/4/9 17:20,1,25,0,0,34,22,56
2023/4/9 17:30,1,25,0,0,36,21,57
2023/4/9 17:40,1,25,0,0,31,30,61
2023/4/9 17:50,1,25,0,0,39,34,73
2023/4/9 18:00,1,25,0,0,50,31,81
2023/4/9 18:10,1,25,0,0,40,33,73
2023/4/9 18:20,1,25,0,0,43,30,73
2023/4/9 18:30,1,25,0,0,44,29,73
2023/4/9 18:40,1,25,0,0,44,22,66
2023/4/9 18:50,1,25,0,0,37,25,62
2023/4/9 19:00,1,25,0,0,34,23,57
2023/4/9 19:10,1,25,0,0,26,18,44
2023/4/9 19:20,1,25,0,0,23,22,45
2023/4/9 19:30,1,25,0,0,22,21,43
2023/4/9 19:40,1,24,0,0,29,20,49
2023/4/9 19:50,1,24,0,0,21,17,38
2023/4/9 20:00,1,24,0,0,22,22,44
2023/4/9 20:10,1,24,0,0,17,22,39
2023/4/9 20:20,1,24,0,0,15,25,40
2023/4/9 20:30,1,24,0,0,19,30,49
2023/4/9 20:40,1,24,0,0,17,27,44
2023/4/9 20:50,1,23,0,0,15,27,42
2023/4/9 21:00,1,23,0,0,10,37,47
2023/4/9 21:10,1,23,0,0,13,28,41
2023/4/9 21:20,1,23,0,0,10,27,37
2023/4/9 21:30,1,23,0,0,12,22,34
2023/4/9 21:40,1,22,0,0,7,37,44
2023/4/9 21:50,1,22,0,0,10,45,55
2023/4/9 22:00,1,22,0,0,5,32,37
2023/4/9 22:10,1,22,0,0,3,33,36
2023/4/9 22:20,1,21,0,0,2,28,30
2023/4/9 22:30,1,21,0,0,2,16,18
2023/4/9 22:40,1,21,0,0,1,12,13
2023/4/9 22:50,1,21,0,0,3,10,13
2023/4/9 23:00,1,21,0,0,2,7,9
2023/4/9 23:10,1,21,0,0,2,6,8
2023/4/9 23:20,1,21,0,0,2,1,3
2023/4/9 23:30,1,20,0,0,2,1,3
2023/4/9 23:40,1,20,0,0,0,2,2
2023/4/9 23:50,1,20,0,0,2,2,4
2023/4/10 0:00,1,20,1,0,4,0,4
2023/4/10 0:10,1,20,1,0,3,2,5
2023/4/10 0:20,1,20,1,0,3,1,4
2023/4/10 0:30,1,20,1,0,2,3,5
2023/4/10 0:40,1,20,1,0,3,0,3
2023/4/10 0:50,1,20,1,0,2,3,5
2023/4/10 1:00,1,19,1,0,3,2,5
2023/4/10 1:10,1,19,1,0,0,3,3
2023/4/10 1:20,1,19,1,0,0,2,2
2023/4/10 1:30,1,19,1,0,3,2,5
2023/4/10 1:40,1,19,1,0,1,1,2
2023/4/10 1:50,1,19,1,0,1,2,3
2023/4/10 2:00,1,19,1,0,1,3,4
2023/4/10 2:10,1,19,1,0,3,1,4
2023/4/10 2:20,1,19,1,0,1,1,2
2023/4/10 2:30,1,18,1,0,0,1,1
2023/4/10 2:40,1,18,1,0,3,3,6
2023/4/10 2:50,1,18,1,0,0,0,0
2023/4/10 3:00,1,18,1,0,3,0,3
2023/4/10 3:10,1,18,1,0,0,0,0
2023/4/10 3:20,1,18,1,0,1,0,1
2023/4/10 3:30,1,18,1,0,1,0,1
2023/4/10 3:40,1,18,1,0,0,0,0
2023/4/10 3:50,1,18,1,0,0,0,0
2023/4/10 4:00,1,18,1,0,1,0,1
2023/4/10 4:10,1,18,1,0,1,2,3
2023/4/10 4:20,1,18,1,0,1,1,2
2023/4/10 4:30,1,18,1,0,2,3,5
2023/4/10 4:40,1,18,1,0,2,2,4
2023/4/10 4:50,1,18,1,0,0,0,0
2023/4/10 5:00,1,18,1,0,1,3,4
2023/4/10 5:10,1,18,1,0,3,2,5
2023/4/10 5:20,1,18,1,0,1,0,1
2023/4/10 5:30,1,19,1,0,2,2,4
2023/4/10 5:40,1,19,1,0,1,1,2
2023/4/10 5:50,1,19,1,0,5,0,5
2023/4/10 6:00,1,19,1,0,4,2,6
2023/4/10 6:10,1,19,1,0,2,1,3
2023/4/10 6:20,1,19,1,0,5,2,7
2023/4/10 6:30,1,19,1,0,5,2,7
2023/4/10 6:40,1,19,1,0,14,3,17
2023/4/10 6:50,1,19,1,0,41,2,43
2023/4/10 7:00,1,19,1,0,61,4,65
2023/4/10 7:10,1,20,1,0,99,0,99
2023/4/10 7:20,1,20,1,0,110,2,112
2023/4/10 7:30,1,20,1,0,284,2,286
2023/4/10 7:40,1,20,1,0,535,6,541
2023/4/10 7:50,1,21,1,0,671,5,676
2023/4/10 8:00,1,21,1,0,280,9,289
2023/4/10 8:10,1,21,1,0,150,12,162
2023/4/10 8:20,1,21,1,0,84,8,92
2023/4/10 8:30,1,21,1,0,79,13,92
2023/4/10 8:40,1,21,1,0,82,13,95
2023/4/10 8:50,1,22,1,0,68,11,79
2023/4/10 9:00,1,22,1,0,86,13,99
2023/4/10 9:10,1,22,1,0,81,18,99
2023/4/10 9:20,1,22,1,0,172,27,199
2023/4/10 9:30,1,22,1,0,222,38,260
2023/4/10 9:40,1,23,1,0,242,136,378
2023/4/10 9:50,1,23,1,0,177,182,359
2023/4/10 10:00,1,23,1,0,128,143,271
2023/4/10 10:10,1,23,1,0,74,100,174
2023/4/10 10:20,1,23,1,0,83,70,153
2023/4/10 10:30,1,23,1,0,66,50,116
2023/4/10 10:40,1,23,1,0,58,41,99
2023/4/10 10:50,1,23,1,0,66,38,104
2023/4/10 11:00,1,23,1,0,74,34,108
2023/4/10 11:10,1,23,1,0,62,34,96
2023/4/10 11:20,1,23,1,0,56,50,106
2023/4/10 11:30,1,24,1,0,67,68,135
2023/4/10 11:40,1,24,1,0,81,195,276
2023/4/10 11:50,1,24,1,0,68,306,374
2023/4/10 12:00,1,24,1,0,62,276,338
2023/4/10 12:10,1,25,1,0,61,189,250
2023/4/10 12:20,1,25,1,0,65,122,187
2023/4/10 12:30,1,25,1,0,56,93,149
2023/4/10 12:40,1,25,1,0,58,64,122
2023/4/10 12:50,1,25,1,0,65,55,120
2023/4/10 13:00,1,25,1,0,65,28,93
2023/4/10 13:10,1,25,1,0,68,29,97
2023/4/10 13:20,1,25,1,0,77,29,106
2023/4/10 13:30,1,25,1,0,152,39,191
2023/4/10 13:40,1,25,1,0,262,37,299
2023/4/10 13:50,1,26,1,0,236,32,268
2023/4/10 14:00,1,26,1,0,119,32,151
2023/4/10 14:10,1,26,1,0,114,37,151
2023/4/10 14:20,1,26,1,0,95,34,129
2023/4/10 14:30,1,26,1,0,77,42,119
2023/4/10 14:40,1,26,1,0,81,47,128
2023/4/10 14:50,1,26,1,0,74,41,115
2023/4/10 15:00,1,26,1,0,78,39,117
2023/4/10 15:10,1,26,1,0,70,39,109
2023/4/10 15:20,1,26,1,0,70,42,112
2023/4/10 15:30,1,26,1,0,96,67,163
2023/4/10 15:40,1,26,1,0,139,194,333
2023/4/10 15:50,1,26,1,0,170,239,409
2023/4/10 16:00,1,26,1,0,104,148,252
2023/4/10 16:10,1,26,1,0,82,120,202
2023/4/10 16:20,1,25,1,0,70,82,152
2023/4/10 16:30,1,25,1,0,70,75,145
2023/4/10 16:40,1,25,1,0,74,52,126
2023/4/10 16:50,1,25,1,0,68,59,127
2023/4/10 17:00,1,25,1,0,66,58,124
2023/4/10 17:10,1,25,1,0,77,58,135
2023/4/10 17:20,1,25,1,0,70,52,122
2023/4/10 17:30,1,25,1,0,87,93,180
2023/4/10 17:40,1,25,1,0,78,221,299
2023/4/10 17:50,1,25,1,0,100,260,360
2023/4/10 18:00,1,25,1,0,83,181,264
2023/4/10 18:10,1,25,1,0,85,135,220
2023/4/10 18:20,1,24,1,0,99,102,201
2023/4/10 18:30,1,24,1,0,99,90,189
2023/4/10 18:40,1,24,1,0,157,75,232
2023/4/10 18:50,1,24,1,0,148,73,221
2023/4/10 19:00,1,24,1,0,115,64,179
2023/4/10 19:10,1,24,1,0,114,68,182
2023/4/10 19:20,1,24,1,0,104,69,173
2023/4/10 19:30,1,24,1,0,90,68,158
2023/4/10 19:40,1,23,1,0,101,54,155
2023/4/10 19:50,1,23,1,0,91,59,150
2023/4/10 20:00,1,23,1,0,84,63,147
2023/4/10 20:10,1,23,1,0,76,69,145
2023/4/10 20:20,1,23,1,0,83,60,143
2023/4/10 20:30,1,23,1,0,62,89,151
2023/4/10 20:40,1,23,1,0,62,170,232
2023/4/10 20:50,1,23,1,0,51,226,277
2023/4/10 21:00,1,23,1,0,51,144,195
2023/4/10 21:10,1,23,1,0,50,132,182
2023/4/10 21:20,1,22,1,0,27,114,141
2023/4/10 21:30,1,22,1,0,22,67,89
2023/4/10 21:40,1,22,1,0,22,72,94
2023/4/10 21:50,1,22,1,0,20,71,91
2023/4/10 22:00,1,22,1,0,15,79,94
2023/4/10 22:10,1,21,1,0,17,84,101
2023/4/10 22:20,1,21,1,0,19,46,65
2023/4/10 22:30,1,21,1,0,17,30,47
2023/4/10 22:40,1,21,1,0,13,21,34
2023/4/10 22:50,1,21,1,0,12,11,23
2023/4/10 23:00,1,21,1,0,12,11,23
2023/4/10 23:10,1,21,1,0,8,13,21
2023/4/10 23:20,1,21,1,0,4,13,17
2023/4/10 23:30,1,21,1,0,3,11,14
2023/4/10 23:40,1,21,1,0,3,8,11
2023/4/10 23:50,1,21,1,0,0,7,7
2023/4/11 0:00,1,21,1,0,6,2,8
2023/4/11 0:10,1,20,1,0,5,1,6
2023/4/11 0:20,1,20,1,0,4,1,5
2023/4/11 0:30,1,20,1,0,0,0,0
2023/4/11 0:40,1,20,1,0,4,2,6
2023/4/11 0:50,1,20,1,0,3,3,6
2023/4/11 1:00,1,20,1,0,2,3,5
2023/4/11 1:10,1,19,1,0,3,0,3
2023/4/11 1:20,1,19,1,0,3,0,3
2023/4/11 1:30,1,19,1,0,1,3,4
2023/4/11 1:40,1,19,1,0,3,3,6
2023/4/11 1:50,1,18,1,0,2,2,4
2023/4/11 2:00,1,18,1,0,2,0,2
2023/4/11 2:10,1,18,1,0,0,0,0
2023/4/11 2:20,1,18,1,0,1,2,3
2023/4/11 2:30,1,18,1,0,2,2,4
2023/4/11 2:40,1,18,1,0,3,2,5
2023/4/11 2:50,1,18,1,0,3,3,6
2023/4/11 3:00,1,18,1,0,1,0,1
2023/4/11 3:10,1,18,1,0,0,1,1
2023/4/11 3:20,1,17,1,0,2,1,3
2023/4/11 3:30,1,17,1,0,2,0,2
2023/4/11 3:40,1,17,1,0,3,3,6
2023/4/11 3:50,1,17,1,0,2,0,2
2023/4/11 4:00,1,17,1,0,0,1,1
2023/4/11 4:10,1,17,1,0,0,0,0
2023/4/11 4:20,1,17,1,0,2,2,4
2023/4/11 4:30,1,17,1,0,3,1,4
2023/4/11 4:40,1,17,1,0,1,3,4
2023/4/11 4:50,1,17,1,0,1,0,1
2023/4/11 5:00,1,17,1,0,0,1,1
2023/4/11 5:10,1,17,1,0,2,1,3
2023/4/11 5:20,1,18,1,0,3,1,4
2023/4/11 5:30,1,18,1,0,4,1,5
2023/4/11 5:40,1,18,1,0,3,3,6
2023/4/11 5:50,1,18,1,0,3,0,3
2023/4/11 6:00,1,18,1,0,2,2,4
2023/4/11 6:10,1,18,1,0,5,3,8
2023/4/11 6:20,1,18,1,0,5,1,6
2023/4/11 6:30,1,19,1,0,6,2,8
2023/4/11 6:40,1,19,1,0,14,2,16
2023/4/11 6:50,1,19,1,0,43,1,44
2023/4/11 7:00,1,19,1,0,66,3,69
2023/4/11 7:10,1,20,1,0,84,0,84
2023/4/11 7:20,1,20,1,0,97,1,98
2023/4/11 7:30,1,21,1,0,348,3,351
2023/4/11 7:40,1,21,1,0,521,6,527
2023/4/11 7:50,1,21,1,0,529,4,533
2023/4/11 8:00,1,21,1,0,329,5,334
2023/4/11 8:10,1,22,1,0,142,12,154
2023/4/11 8:20,1,23,1,0,86,9,95
2023/4/11 8:30,1,23,1,0,77,15,92
2023/4/11 8:40,1,23,1,0,75,13,88
2023/4/11 8:50,1,23,1,0,79,12,91
2023/4/11 9:00,1,23,1,0,86,16,102
2023/4/11 9:10,1,23,1,0,94,15,109
2023/4/11 9:20,1,23,1,0,160,27,187
2023/4/11 9:30,1,23,1,0,233,38,271
2023/4/11 9:40,1,23,1,0,279,140,419
2023/4/11 9:50,1,23,1,0,200,174,374
2023/4/11 10:00,1,24,1,0,135,167,302
2023/4/11 10:10,1,24,1,0,81,95,176
2023/4/11 10:20,1,24,1,0,86,79,165
2023/4/11 10:30,1,24,1,0,68,56,124
2023/4/11 10:40,1,24,1,0,70,47,117
2023/4/11 10:50,1,24,1,0,61,38,99
2023/4/11 11:00,1,24,1,0,63,39,102
2023/4/11 11:10,1,24,1,0,64,40,104
2023/4/11 11:20,1,24,1,0,68,40,108
2023/4/11 11:30,1,25,1,0,69,72,141
2023/4/11 11:40,1,25,1,0,76,248,324
2023/4/11 11:50,1,25,1,0,59,306,365
2023/4/11 12:00,1,25,1,0,59,243,302
2023/4/11 12:10,1,26,1,0,55,170,225
2023/4/11 12:20,1,26,1,0,63,118,181
2023/4/11 12:30,1,26,1,0,69,94,163
2023/4/11 12:40,1,26,1,0,61,71,132
2023/4/11 12:50,1,26,1,0,64,45,109
2023/4/11 13:00,1,26,1,0,64,30,94
2023/4/11 13:10,1,26,1,0,70,35,105
2023/4/11 13:20,1,26,1,0,92,33,125
2023/4/11 13:30,1,26,1,0,181,37,218
2023/4/11 13:40,1,26,1,0,239,31,270
2023/4/11 13:50,1,26,1,0,262,39,301
2023/4/11 14:00,1,27,1,0,115,27,142
2023/4/11 14:10,1,27,1,0,119,35,154
2023/4/11 14:20,1,27,1,0,93,34,127
2023/4/11 14:30,1,27,1,0,96,42,138
2023/4/11 14:40,1,27,1,0,78,40,118
2023/4/11 14:50,1,27,1,0,64,47,111
2023/4/11 15:00,1,28,1,0,67,48,115
2023/4/11 15:10,1,28,1,0,65,37,102
2023/4/11 15:20,1,28,1,0,69,36,105
2023/4/11 15:30,1,28,1,0,80,71,151
2023/4/11 15:40,1,28,1,0,150,191,341
2023/4/11 15:50,1,28,1,0,158,202,360
2023/4/11 16:00,1,28,1,0,116,130,246
2023/4/11 16:10,1,28,1,0,89,127,216
2023/4/11 16:20,1,28,1,0,76,77,153
2023/4/11 16:30,1,28,1,0,76,64,140
2023/4/11 16:40,1,27,1,0,65,61,126
2023/4/11 16:50,1,27,1,0,76,67,143
2023/4/11 17:00,1,27,1,0,75,55,130
2023/4/11 17:10,1,27,1,0,64,56,120
2023/4/11 17:20,1,27,1,0,78,53,131
2023/4/11 17:30,1,27,1,0,74,72,146
2023/4/11 17:40,1,27,1,0,81,244,325
2023/4/11 17:50,1,27,1,0,104,245,349
2023/4/11 18:00,1,27,1,0,83,230,313
2023/4/11 18:10,1,27,1,0,94,155,249
2023/4/11 18:20,1,27,1,0,90,91,181
2023/4/11 18:30,1,26,1,0,127,80,207
2023/4/11 18:40,1,26,1,0,194,73,267
2023/4/11 18:50,1,26,1,0,183,64,247
2023/4/11 19:00,1,26,1,0,147,71,218
2023/4/11 19:10,1,26,1,0,130,60,190
2023/4/11 19:20,1,26,1,0,100,69,169
2023/4/11 19:30,1,26,1,0,96,54,150
2023/4/11 19:40,1,26,1,0,94,61,155
2023/4/11 19:50,1,26,1,0,91,65,156
2023/4/11 20:00,1,25,1,0,70,62,132
2023/4/11 20:10,1,25,1,0,80,59,139
2023/4/11 20:20,1,25,1,0,75,71,146
2023/4/11 20:30,1,25,1,0,66,90,156
2023/4/11 20:40,1,25,1,0,68,179,247
2023/4/11 20:50,1,25,1,0,53,232,285
2023/4/11 21:00,1,25,1,0,42,185,227
2023/4/11 21:10,1,24,1,0,51,122,173
2023/4/11 21:20,1,24,1,0,33,118,151
2023/4/11 21:30,1,24,1,0,26,71,97
2023/4/11 21:40,1,24,1,0,16,72,88
2023/4/11 21:50,1,24,1,0,18,77,95
2023/4/11 22:00,1,24,1,0,15,94,109
2023/4/11 22:10,1,24,1,0,17,80,97
2023/4/11 22:20,1,24,1,0,16,45,61
2023/4/11 22:30,1,24,1,0,16,33,49
2023/4/11 22:40,1,23,1,0,10,18,28
2023/4/11 22:50,1,23,1,0,13,13,26
2023/4/11 23:00,1,23,1,0,12,13,25
2023/4/11 23:10,1,23,1,0,9,15,24
2023/4/11 23:20,1,23,1,0,7,11,18
2023/4/11 23:30,1,23,1,0,4,8,12
2023/4/11 23:40,1,23,1,0,1,10,11
2023/4/11 23:50,1,23,1,0,1,5,6
2023/4/12 0:00,1,23,1,0,5,2,7
2023/4/12 0:10,1,22,1,0,4,0,4
2023/4/12 0:20,1,22,1,0,2,2,4
2023/4/12 0:30,1,22,1,0,0,0,0
2023/4/12 0:40,1,22,1,0,1,0,1
2023/4/12 0:50,1,21,1,0,1,2,3
2023/4/12 1:00,1,21,1,0,1,2,3
2023/4/12 1:10,1,21,1,0,0,0,0
2023/4/12 1:20,1,21,1,0,2,1,3
2023/4/12 1:30,1,21,1,0,2,2,4
2023/4/12 1:40,1,21,1,0,1,1,2
2023/4/12 1:50,1,21,1,0,2,2,4
2023/4/12 2:00,1,21,1,0,0,0,0
2023/4/12 2:10,1,20,1,0,0,2,2
2023/4/12 2:20,1,20,1,0,2,2,4
2023/4/12 2:30,1,20,1,0,1,1,2
2023/4/12 2:40,1,20,1,0,2,1,3
2023/4/12 2:50,1,19,1,0,0,2,2
2023/4/12 3:00,1,19,1,0,0,2,2
2023/4/12 3:10,1,19,1,0,1,1,2
2023/4/12 3:20,1,19,1,0,1,2,3
2023/4/12 3:30,1,19,1,0,1,2,3
2023/4/12 3:40,1,19,1,0,1,0,1
2023/4/12 3:50,1,19,1,0,1,2,3
2023/4/12 4:00,1,19,1,0,1,2,3
2023/4/12 4:10,1,19,1,0,1,2,3
2023/4/12 4:20,1,19,1,0,0,0,0
2023/4/12 4:30,1,19,1,0,1,1,2
2023/4/12 4:40,1,19,1,0,2,2,4
2023/4/12 4:50,1,19,1,0,0,1,1
2023/4/12 5:00,1,19,1,0,1,2,3
2023/4/12 5:10,1,20,1,0,1,1,2
2023/4/12 5:20,1,20,1,0,1,0,1
2023/4/12 5:30,1,20,1,0,1,2,3
2023/4/12 5:40,1,20,1,0,1,2,3
2023/4/12 5:50,1,21,1,0,5,0,5
2023/4/12 6:00,1,21,1,0,3,4,7
2023/4/12 6:10,1,21,1,0,2,2,4
2023/4/12 6:20,1,21,1,0,5,2,7
2023/4/12 6:30,1,21,1,0,6,2,8
2023/4/12 6:40,1,21,1,0,12,0,12
2023/4/12 6:50,1,21,1,0,41,0,41
2023/4/12 7:00,1,22,1,0,67,3,70
2023/4/12 7:10,1,22,1,0,93,2,95
2023/4/12 7:20,1,22,1,0,123,2,125
2023/4/12 7:30,1,22,1,0,320,0,320
2023/4/12 7:40,1,23,1,0,502,4,506
2023/4/12 7:50,1,23,1,0,620,6,626
2023/4/12 8:00,1,23,1,0,284,8,292
2023/4/12 8:10,1,23,1,0,147,8,155
2023/4/12 8:20,1,23,1,0,103,8,111
2023/4/12 8:30,1,23,1,0,76,14,90
2023/4/12 8:40,1,23,1,0,86,12,98
2023/4/12 8:50,1,23,1,0,65,10,75
2023/4/12 9:00,1,23,1,0,77,15,92
2023/4/12 9:10,1,23,1,0,80,16,96
2023/4/12 9:20,1,23,1,0,138,31,169
2023/4/12 9:30,1,24,1,0,202,40,242
2023/4/12 9:40,1,24,1,0,242,136,378
2023/4/12 9:50,1,24,1,0,170,162,332
2023/4/12 10:00,1,24,1,0,132,162,294
2023/4/12 10:10,1,24,1,0,87,96,183
2023/4/12 10:20,1,24,1,0,82,68,150
2023/4/12 10:30,1,24,1,0,57,50,107
2023/4/12 10:40,1,25,1,0,64,46,110
2023/4/12 10:50,1,25,1,0,69,42,111
2023/4/12 11:00,1,25,1,0,61,38,99
2023/4/12 11:10,1,25,1,0,66,36,102
2023/4/12 11:20,1,25,1,0,62,40,102
2023/4/12 11:30,1,26,1,0,76,80,156
2023/4/12 11:40,1,26,1,0,76,238,314
2023/4/12 11:50,1,26,1,0,66,252,318
2023/4/12 12:00,1,26,1,0,56,244,300
2023/4/12 12:10,1,26,1,0,54,163,217
2023/4/12 12:20,1,26,1,0,55,120,175
2023/4/12 12:30,1,27,1,0,45,94,139
2023/4/12 12:40,1,27,1,0,25,72,97
2023/4/12 12:50,1,27,1,0,20,53,73
2023/4/12 13:00,1,27,1,0,19,32,51
2023/4/12 13:10,1,27,1,0,11,20,31
2023/4/12 13:20,1,27,1,0,16,14,30
2023/4/12 13:30,1,27,1,0,19,15,34
2023/4/12 13:40,1,27,1,0,34,23,57
2023/4/12 13:50,1,27,1,0,32,23,55
2023/4/12 14:00,1,28,1,0,30,20,50
2023/4/12 14:10,1,28,1,0,22,26,48
2023/4/12 14:20,1,28,1,0,18,16,34
2023/4/12 14:30,1,28,1,0,18,18,36
2023/4/12 14:40,1,29,1,0,18,19,37
2023/4/12 14:50,1,29,1,0,22,18,40
2023/4/12 15:00,1,29,1,0,26,13,39
2023/4/12 15:10,1,29,1,0,31,15,46
2023/4/12 15:20,1,29,1,0,31,17,48
2023/4/12 15:30,1,29,1,0,30,17,47
2023/4/12 15:40,1,29,1,0,31,25,56
2023/4/12 15:50,1,29,1,0,33,18,51
2023/4/12 16:00,1,29,1,0,26,18,44
2023/4/12 16:10,1,29,1,0,26,16,42
2023/4/12 16:20,1,29,1,0,28,14,42
2023/4/12 16:30,1,29,1,0,31,12,43
2023/4/12 16:40,1,29,1,0,34,11,45
2023/4/12 16:50,1,29,1,0,36,18,54
2023/4/12 17:00,1,29,1,0,41,24,65
2023/4/12 17:10,1,29,1,0,44,21,65
2023/4/12 17:20,1,29,1,0,42,24,66
2023/4/12 17:30,1,28,1,0,45,32,77
2023/4/12 17:40,1,28,1,0,42,40,82
2023/4/12 17:50,1,28,1,0,41,41,82
2023/4/12 18:00,1,28,1,0,49,36,85
2023/4/12 18:10,1,28,1,0,54,35,89
2023/4/12 18:20,1,28,1,0,59,33,92
2023/4/12 18:30,1,28,1,0,52,36,88
2023/4/12 18:40,1,28,1,0,53,34,87
2023/4/12 18:50,1,27,1,0,47,39,86
2023/4/12 19:00,1,27,1,0,41,24,65
2023/4/12 19:10,1,27,1,0,35,25,60
2023/4/12 19:20,1,27,1,0,28,23,51
2023/4/12 19:30,1,27,1,0,31,25,56
2023/4/12 19:40,1,27,1,0,27,25,52
2023/4/12 19:50,1,26,1,0,26,22,48
2023/4/12 20:00,1,26,1,0,30,26,56
2023/4/12 20:10,1,26,1,0,22,21,43
2023/4/12 20:20,1,26,1,0,20,28,48
2023/4/12 20:30,1,26,1,0,21,36,57
2023/4/12 20:40,1,25,1,0,21,32,53
2023/4/12 20:50,1,25,1,0,19,40,59
2023/4/12 21:00,1,25,1,0,13,44,57
2023/4/12 21:10,1,25,1,0,18,33,51
2023/4/12 21:20,1,25,1,0,13,32,45
2023/4/12 21:30,1,25,1,0,11,31,42
2023/4/12 21:40,1,25,1,0,8,47,55
2023/4/12 21:50,1,25,1,0,12,51,63
2023/4/12 22:00,1,25,1,0,6,47,53
2023/4/12 22:10,1,25,1,0,5,41,46
2023/4/12 22:20,1,25,1,0,3,36,39
2023/4/12 22:30,1,24,1,0,1,21,22
2023/4/12 22:40,1,24,1,0,3,16,19
2023/4/12 22:50,1,24,1,0,4,11,15
2023/4/12 23:00,1,24,1,0,2,8,10
2023/4/12 23:10,1,24,1,0,1,5,6
2023/4/12 23:20,1,24,1,0,0,1,1
2023/4/12 23:30,1,24,1,0,2,0,2
2023/4/12 23:40,1,24,1,0,1,2,3
2023/4/12 23:50,1,24,1,0,2,0,2
2023/4/13 0:00,1,24,1,0,4,2,6
2023/4/13 0:10,1,23,1,0,3,3,6
2023/4/13 0:20,1,23,1,0,2,2,4
2023/4/13 0:30,1,23,1,0,2,0,2
2023/4/13 0:40,1,23,1,0,1,0,1
2023/4/13 0:50,1,23,1,0,3,1,4
2023/4/13 1:00,1,23,1,0,1,0,1
2023/4/13 1:10,1,22,1,0,0,1,1
2023/4/13 1:20,1,22,1,0,3,0,3
2023/4/13 1:30,1,22,1,0,2,3,5
2023/4/13 1:40,1,22,1,0,0,0,0
2023/4/13 1:50,1,22,1,0,0,2,2
2023/4/13 2:00,1,21,1,0,1,2,3
2023/4/13 2:10,1,21,1,0,2,3,5
2023/4/13 2:20,1,21,1,0,0,1,1
2023/4/13 2:30,1,21,1,0,2,1,3
2023/4/13 2:40,1,21,1,0,2,2,4
2023/4/13 2:50,1,21,1,0,3,2,5
2023/4/13 3:00,1,21,1,0,1,1,2
2023/4/13 3:10,1,21,1,0,3,2,5
2023/4/13 3:20,1,20,1,0,1,0,1
2023/4/13 3:30,1,20,1,0,0,1,1
2023/4/13 3:40,1,20,1,0,2,0,2
2023/4/13 3:50,1,20,1,0,1,3,4
2023/4/13 4:00,1,20,1,0,3,2,5
2023/4/13 4:10,1,20,1,0,3,0,3
2023/4/13 4:20,1,20,1,0,1,1,2
2023/4/13 4:30,1,21,1,0,1,2,3
2023/4/13 4:40,1,21,1,0,2,3,5
2023/4/13 4:50,1,21,1,0,3,3,6
2023/4/13 5:00,1,21,1,0,1,2,3
2023/4/13 5:10,1,21,1,0,1,1,2
2023/4/13 5:20,1,21,1,0,2,1,3
2023/4/13 5:30,1,21,1,0,3,1,4
2023/4/13 5:40,1,21,1,0,0,3,3
2023/4/13 5:50,1,21,1,0,5,2,7
2023/4/13 6:00,1,21,1,0,4,3,7
2023/4/13 6:10,1,22,1,0,3,3,6
2023/4/13 6:20,1,22,1,0,4,3,7
2023/4/13 6:30,1,22,1,0,6,3,9
2023/4/13 6:40,1,22,1,0,10,3,13
2023/4/13 6:50,1,22,1,0,34,2,36
2023/4/13 7:00,1,22,1,0,63,5,68
2023/4/13 7:10,1,22,1,0,93,2,95
2023/4/13 7:20,1,22,1,0,109,3,112
2023/4/13 7:30,1,22,1,0,320,0,320
2023/4/13 7:40,1,23,1,0,586,5,591
2023/4/13 7:50,1,23,1,0,682,4,686
2023/4/13 8:00,1,23,1,0,274,8,282
2023/4/13 8:10,1,23,1,0,135,12,147
2023/4/13 8:20,1,24,1,0,102,11,113
2023/4/13 8:30,1,24,1,0,73,11,84
2023/4/13 8:40,1,24,1,0,78,16,94
2023/4/13 8:50,1,24,1,0,79,11,90
2023/4/13 9:00,1,25,1,0,88,17,105
2023/4/13 9:10,1,25,1,0,95,20,115
2023/4/13 9:20,1,26,1,0,164,29,193
2023/4/13 9:30,1,26,1,0,202,47,249
2023/4/13 9:40,1,26,1,0,280,121,401
2023/4/13 9:50,1,26,1,0,177,170,347
2023/4/13 10:00,1,26,1,0,134,152,286
2023/4/13 10:10,1,26,1,0,72,109,181
2023/4/13 10:20,1,27,1,0,77,65,142
2023/4/13 10:30,1,27,1,0,68,54,122
2023/4/13 10:40,1,27,1,0,67,49,116
2023/4/13 10:50,1,27,1,0,71,44,115
2023/4/13 11:00,1,27,1,0,74,34,108
2023/4/13 11:10,1,27,1,0,63,34,97
2023/4/13 11:20,1,27,1,0,60,51,111
2023/4/13 11:30,1,27,1,0,73,75,148
2023/4/13 11:40,1,28,1,0,78,197,275
2023/4/13 11:50,1,28,1,0,59,288,347
2023/4/13 12:00,1,28,1,0,61,247,308
2023/4/13 12:10,1,28,1,0,63,165,228
2023/4/13 12:20,1,28,1,0,58,106,164
2023/4/13 12:30,1,28,1,0,58,90,148
2023/4/13 12:40,1,29,1,0,62,65,127
2023/4/13 12:50,1,29,1,0,59,56,115
2023/4/13 13:00,1,29,1,0,56,26,82
2023/4/13 13:10,1,29,1,0,70,36,106
2023/4/13 13:20,1,29,1,0,92,30,122
2023/4/13 13:30,1,29,1,0,176,36,212
2023/4/13 13:40,1,29,1,0,258,31,289
2023/4/13 13:50,1,29,1,0,251,37,288
2023/4/13 14:00,1,29,1,0,120,29,149
2023/4/13 14:10,1,29,1,0,99,37,136
2023/4/13 14:20,1,29,1,0,91,41,132
2023/4/13 14:30,1,29,1,0,95,37,132
2023/4/13 14:40,1,29,1,0,86,49,135
2023/4/13 14:50,1,28,1,0,67,38,105
2023/4/13 15:00,1,28,1,0,71,47,118
2023/4/13 15:10,1,28,1,0,78,44,122
2023/4/13 15:20,1,28,1,0,68,41,109
2023/4/13 15:30,1,28,1,0,76,58,134
2023/4/13 15:40,1,28,1,0,149,161,310
2023/4/13 15:50,1,28,1,0,148,190,338
2023/4/13 16:00,1,28,1,0,106,150,256
2023/4/13 16:10,1,28,1,0,93,114,207
2023/4/13 16:20,1,28,1,0,68,77,145
2023/4/13 16:30,1,28,1,0,74,62,136
2023/4/13 16:40,1,27,1,0,63,54,117
2023/4/13 16:50,1,27,1,0,79,69,148
2023/4/13 17:00,1,27,1,0,77,50,127
2023/4/13 17:10,1,27,1,0,65,59,124
2023/4/13 17:20,1,27,1,0,72,53,125
2023/4/13 17:30,1,27,1,0,85,81,166
2023/4/13 17:40,1,27,1,0,86,232,318
2023/4/13 17:50,1,26,1,0,91,258,349
2023/4/13 18:00,1,26,1,0,87,191,278
2023/4/13 18:10,1,26,1,0,93,127,220
2023/4/13 18:20,1,26,1,0,85,87,172
2023/4/13 18:30,1,25,1,0,101,84,185
2023/4/13 18:40,1,25,1,0,200,77,277
2023/4/13 18:50,1,25,1,0,190,76,266
2023/4/13 19:00,1,25,1,0,143,67,210
2023/4/13 19:10,1,25,1,0,127,64,191
2023/4/13 19:20,1,24,1,0,97,56,153
2023/4/13 19:30,1,23,1,0,86,55,141
2023/4/13 19:40,1,23,1,0,93,66,159
2023/4/13 19:50,1,23,1,0,94,67,161
2023/4/13 20:00,1,23,1,0,81,67,148
2023/4/13 20:10,1,23,1,0,80,56,136
2023/4/13 20:20,1,23,1,0,76,61,137
2023/4/13 20:30,1,22,1,0,70,83,153
2023/4/13 20:40,1,22,1,0,57,214,271
2023/4/13 20:50,1,22,1,0,56,237,293
2023/4/13 21:00,1,22,1,0,46,152,198
2023/4/13 21:10,1,22,1,0,44,124,168
2023/4/13 21:20,1,22,1,0,33,121,154
2023/4/13 21:30,1,22,1,0,27,72,99
2023/4/13 21:40,1,21,1,0,22,68,90
2023/4/13 21:50,1,21,1,0,20,81,101
2023/4/13 22:00,1,21,1,0,17,91,108
2023/4/13 22:10,1,21,1,0,18,78,96
2023/4/13 22:20,1,20,1,0,16,51,67
2023/4/13 22:30,1,19,1,0,16,36,52
2023/4/13 22:40,1,19,1,0,14,22,36
2023/4/13 22:50,1,19,1,0,9,16,25
2023/4/13 23:00,1,19,1,0,11,11,22
2023/4/13 23:10,1,19,1,0,5,15,20
2023/4/13 23:20,1,19,1,0,5,12,17
2023/4/13 23:30,1,19,1,0,2,8,10
2023/4/13 23:40,1,19,1,0,1,10,11
2023/4/13 23:50,1,19,1,0,0,7,7
2023/4/14 0:00,1,18,1,0,3,0,3
2023/4/14 0:10,1,18,1,0,4,1,5
2023/4/14 0:20,1,18,1,0,3,2,5
2023/4/14 0:30,1,18,1,0,2,2,4
2023/4/14 0:40,1,18,1,0,1,1,2
2023/4/14 0:50,1,18,1,0,0,2,2
2023/4/14 1:00,1,17,1,0,2,0,2
2023/4/14 1:10,1,17,1,0,2,1,3
2023/4/14 1:20,1,17,1,0,1,0,1
2023/4/14 1:30,1,17,1,0,0,0,0
2023/4/14 1:40,1,17,1,0,1,1,2
2023/4/14 1:50,1,17,1,0,1,0,1
2023/4/14 2:00,1,17,1,0,2,1,3
2023/4/14 2:10,1,16,1,0,1,2,3
2023/4/14 2:20,1,16,1,0,0,2,2
2023/4/14 2:30,1,16,1,0,2,0,2
2023/4/14 2:40,1,16,1,0,0,2,2
2023/4/14 2:50,1,15,1,0,1,1,2
2023/4/14 3:00,1,15,1,0,0,0,0
2023/4/14 3:10,1,15,1,0,1,1,2
2023/4/14 3:20,1,15,1,0,1,1,2
2023/4/14 3:30,1,15,1,0,1,2,3
2023/4/14 3:40,1,15,1,0,1,2,3
2023/4/14 3:50,1,15,1,0,0,0,0
2023/4/14 4:00,1,15,1,0,1,1,2
2023/4/14 4:10,1,15,1,0,2,0,2
2023/4/14 4:20,1,15,1,0,1,0,1
2023/4/14 4:30,1,15,1,0,0,2,2
2023/4/14 4:40,1,16,1,0,1,2,3
2023/4/14 4:50,1,16,1,0,0,0,0
2023/4/14 5:00,1,17,1,0,1,0,1
2023/4/14 5:10,1,17,1,0,0,0,0
2023/4/14 5:20,1,17,1,0,1,2,3
2023/4/14 5:30,1,17,1,0,3,0,3
2023/4/14 5:40,1,17,1,0,0,1,1
2023/4/14 5:50,1,17,1,0,4,0,4
2023/4/14 6:00,1,17,1,0,4,2,6
2023/4/14 6:10,1,17,1,0,3,2,5
2023/4/14 6:20,1,18,1,0,7,2,9
2023/4/14 6:30,1,18,1,0,6,4,10
2023/4/14 6:40,1,18,1,0,13,0,13
2023/4/14 6:50,1,18,1,0,39,2,41
2023/4/14 7:00,1,18,1,0,57,2,59
2023/4/14 7:10,1,18,1,0,92,1,93
2023/4/14 7:20,1,18,1,0,104,3,107
2023/4/14 7:30,1,18,1,0,356,1,357
2023/4/14 7:40,1,18,1,0,626,3,629
2023/4/14 7:50,1,19,1,0,632,6,638
2023/4/14 8:00,1,19,1,0,290,8,298
2023/4/14 8:10,1,19,1,0,148,12,160
2023/4/14 8:20,1,19,1,0,83,10,93
2023/4/14 8:30,1,19,1,0,82,11,93
2023/4/14 8:40,1,19,1,0,83,16,99
2023/4/14 8:50,1,20,1,0,83,13,96
2023/4/14 9:00,1,20,1,0,76,15,91
2023/4/14 9:10,1,20,1,0,77,16,93
2023/4/14 9:20,1,20,1,0,150,32,182
2023/4/14 9:30,1,20,1,0,231,41,272
2023/4/14 9:40,1,20,1,0,224,127,351
2023/4/14 9:50,1,21,1,0,216,172,388
2023/4/14 10:00,1,21,1,0,142,131,273
2023/4/14 10:10,1,21,1,0,89,88,177
2023/4/14 10:20,1,21,1,0,84,62,146
2023/4/14 10:30,1,21,1,0,68,49,117
2023/4/14 10:40,1,21,1,0,69,44,113
2023/4/14 10:50,1,21,1,0,69,43,112
2023/4/14 11:00,1,22,1,0,75,40,115
2023/4/14 11:10,1,22,1,0,54,43,97
2023/4/14 11:20,1,22,1,0,59,49,108
2023/4/14 11:30,1,22,1,0,72,75,147
2023/4/14 11:40,1,22,1,0,76,248,324
2023/4/14 11:50,1,22,1,0,73,277,350
2023/4/14 12:00,1,22,1,0,63,243,306
2023/4/14 12:10,1,22,1,0,48,180,228
2023/4/14 12:20,1,22,1,0,60,119,179
2023/4/14 12:30,1,22,1,0,70,95,165
2023/4/14 12:40,1,23,1,0,54,73,127
2023/4/14 12:50,1,23,1,0,61,45,106
2023/4/14 13:00,1,23,1,0,70,30,100
2023/4/14 13:10,1,23,1,0,64,33,97
2023/4/14 13:20,1,24,1,0,97,36,133
2023/4/14 13:30,1,24,1,0,154,33,187
2023/4/14 13:40,1,24,1,0,258,40,298
2023/4/14 13:50,1,24,1,0,268,34,302
2023/4/14 14:00,1,24,1,0,125,33,158
2023/4/14 14:10,1,24,1,0,112,35,147
2023/4/14 14:20,1,24,1,0,87,34,121
2023/4/14 14:30,1,24,1,0,89,40,129
2023/4/14 14:40,1,24,1,0,71,46,117
2023/4/14 14:50,1,24,1,0,64,43,107
2023/4/14 15:00,1,24,1,0,66,48,114
2023/4/14 15:10,1,24,1,0,76,45,121
2023/4/14 15:20,1,24,1,0,80,38,118
2023/4/14 15:30,1,24,1,0,97,60,157
2023/4/14 15:40,1,24,1,0,154,168,322
2023/4/14 15:50,1,24,1,0,156,202,358
2023/4/14 16:00,1,24,1,0,94,137,231
2023/4/14 16:10,1,24,1,0,81,127,208
2023/4/14 16:20,1,24,1,0,72,79,151
2023/4/14 16:30,1,24,1,0,82,65,147
2023/4/14 16:40,1,24,1,0,77,61,138
2023/4/14 16:50,1,23,1,0,65,69,134
2023/4/14 17:00,1,23,1,0,67,55,122
2023/4/14 17:10,1,23,1,0,73,62,135
2023/4/14 17:20,1,23,1,0,71,49,120
2023/4/14 17:30,1,23,1,0,74,79,153
2023/4/14 17:40,1,23,1,0,83,240,323
2023/4/14 17:50,1,23,1,0,105,238,343
2023/4/14 18:00,1,22,1,0,104,206,310
2023/4/14 18:10,1,22,1,0,76,154,230
2023/4/14 18:20,1,22,1,0,94,92,186
2023/4/14 18:30,1,22,1,0,101,88,189
2023/4/14 18:40,1,22,1,0,197,65,262
2023/4/14 18:50,1,22,1,0,172,64,236
2023/4/14 19:00,1,22,1,0,137,65,202
2023/4/14 19:10,1,21,1,0,125,54,179
2023/4/14 19:20,1,21,1,0,93,63,156
2023/4/14 19:30,1,21,1,0,81,62,143
2023/4/14 19:40,1,21,1,0,87,51,138
2023/4/14 19:50,1,21,1,0,87,57,144
2023/4/14 20:00,1,21,1,0,81,67,148
2023/4/14 20:10,1,21,1,0,88,70,158
2023/4/14 20:20,1,21,1,0,85,71,156
2023/4/14 20:30,1,21,1,0,59,82,141
2023/4/14 20:40,1,20,1,0,69,219,288
2023/4/14 20:50,1,20,1,0,58,237,295
2023/4/14 21:00,1,20,1,0,49,163,212
2023/4/14 21:10,1,20,1,0,47,120,167
2023/4/14 21:20,1,20,1,0,31,109,140
2023/4/14 21:30,1,20,1,0,20,77,97
2023/4/14 21:40,1,20,1,0,19,71,90
2023/4/14 21:50,1,20,1,0,17,77,94
2023/4/14 22:00,1,20,1,0,14,83,97
2023/4/14 22:10,1,19,1,0,16,73,89
2023/4/14 22:20,1,19,1,0,17,44,61
2023/4/14 22:30,1,19,1,0,16,33,49
2023/4/14 22:40,1,19,1,0,13,20,33
2023/4/14 22:50,1,19,1,0,8,15,23
2023/4/14 23:00,1,19,1,0,8,14,22
2023/4/14 23:10,1,18,1,0,7,10,17
2023/4/14 23:20,1,18,1,0,7,8,15
2023/4/14 23:30,1,18,1,0,1,10,11
2023/4/14 23:40,1,18,1,0,1,11,12
2023/4/14 23:50,1,18,1,0,2,3,5
2023/4/15 0:00,1,18,0,0,3,2,5
2023/4/15 0:10,1,18,0,0,2,0,2
2023/4/15 0:20,1,18,0,0,0,1,1
2023/4/15 0:30,1,18,0,0,0,0,0
2023/4/15 0:40,1,18,0,0,1,0,1
2023/4/15 0:50,1,18,0,0,1,0,1
2023/4/15 1:00,1,17,0,0,2,2,4
2023/4/15 1:10,1,17,0,0,1,2,3
2023/4/15 1:20,1,17,0,0,0,2,2
2023/4/15 1:30,1,17,0,0,2,2,4
2023/4/15 1:40,1,17,0,0,1,0,1
2023/4/15 1:50,1,17,0,0,0,2,2
2023/4/15 2:00,1,17,0,0,2,1,3
2023/4/15 2:10,1,16,0,0,2,1,3
2023/4/15 2:20,1,16,0,0,0,1,1
2023/4/15 2:30,1,16,0,0,2,2,4
2023/4/15 2:40,1,15,0,0,2,1,3
2023/4/15 2:50,1,15,0,0,2,0,2
2023/4/15 3:00,1,15,0,0,1,0,1
2023/4/15 3:10,1,15,0,0,0,1,1
2023/4/15 3:20,1,15,0,0,2,2,4
2023/4/15 3:30,1,15,0,0,2,1,3
2023/4/15 3:40,1,15,0,0,1,1,2
2023/4/15 3:50,1,15,0,0,1,0,1
2023/4/15 4:00,1,15,0,0,0,0,0
2023/4/15 4:10,1,15,0,0,0,2,2
2023/4/15 4:20,1,15,0,0,2,2,4
2023/4/15 4:30,1,15,0,0,1,0,1
2023/4/15 4:40,1,15,0,0,2,0,2
2023/4/15 4:50,1,15,0,0,0,0,0
2023/4/15 5:00,1,15,0,0,1,0,1
2023/4/15 5:10,1,15,0,0,2,1,3
2023/4/15 5:20,1,16,0,0,1,2,3
2023/4/15 5:30,1,16,0,0,0,0,0
2023/4/15 5:40,1,16,0,0,2,2,4
2023/4/15 5:50,1,16,0,0,4,2,6
2023/4/15 6:00,1,16,0,0,7,0,7
2023/4/15 6:10,1,16,0,0,9,2,11
2023/4/15 6:20,1,16,0,0,6,0,6
2023/4/15 6:30,1,16,0,0,10,3,13
2023/4/15 6:40,1,16,0,0,13,2,15
2023/4/15 6:50,1,16,0,0,11,3,14
2023/4/15 7:00,1,16,0,0,16,2,18
2023/4/15 7:10,1,16,0,0,21,3,24
2023/4/15 7:20,1,16,0,0,45,2,47
2023/4/15 7:30,1,16,0,0,55,5,60
2023/4/15 7:40,1,17,0,0,52,3,55
2023/4/15 7:50,1,17,0,0,55,2,57
2023/4/15 8:00,1,17,0,0,43,6,49
2023/4/15 8:10,1,17,0,0,45,3,48
2023/4/15 8:20,1,18,0,0,32,0,32
2023/4/15 8:30,1,18,0,0,30,2,32
2023/4/15 8:40,1,18,0,0,32,5,37
2023/4/15 8:50,1,18,0,0,34,4,38
2023/4/15 9:00,1,19,0,0,27,2,29
2023/4/15 9:10,1,19,0,0,37,5,42
2023/4/15 9:20,1,19,0,0,31,5,36
2023/4/15 9:30,1,19,0,0,35,15,50
2023/4/15 9:40,1,19,0,0,34,14,48
2023/4/15 9:50,1,19,0,0,44,9,53
2023/4/15 10:00,1,20,0,0,31,14,45
2023/4/15 10:10,1,20,0,0,27,12,39
2023/4/15 10:20,1,20,0,0,20,8,28
2023/4/15 10:30,1,21,0,0,19,13,32
2023/4/15 10:40,1,21,0,0,20,16,36
2023/4/15 10:50,1,21,0,0,19,15,34
2023/4/15 11:00,1,21,0,0,14,18,32
2023/4/15 11:10,1,21,0,0,16,17,33
2023/4/15 11:20,1,21,0,0,10,18,28
2023/4/15 11:30,1,21,0,0,15,21,36
2023/4/15 11:40,1,21,0,0,11,27,38
2023/4/15 11:50,1,21,0,0,13,29,42
2023/4/15 12:00,1,22,0,0,11,35,46
2023/4/15 12:10,1,22,0,0,12,30,42
2023/4/15 12:20,1,22,0,0,12,30,42
2023/4/15 12:30,1,22,0,0,17,32,49
2023/4/15 12:40,1,22,0,0,12,35,47
2023/4/15 12:50,1,23,0,0,8,30,38
2023/4/15 13:00,1,23,0,0,10,25,35
2023/4/15 13:10,1,23,0,0,12,19,31
2023/4/15 13:20,1,23,0,0,14,14,28
2023/4/15 13:30,1,23,0,0,16,14,30
2023/4/15 13:40,1,23,0,0,22,15,37
2023/4/15 13:50,1,23,0,0,23,22,45
2023/4/15 14:00,1,24,0,0,24,18,42
2023/4/15 14:10,1,24,0,0,15,21,36
2023/4/15 14:20,1,24,0,0,15,15,30
2023/4/15 14:30,1,24,0,0,17,16,33
2023/4/15 14:40,1,24,0,0,17,13,30
2023/4/15 14:50,1,25,0,0,19,16,35
2023/4/15 15:00,1,25,0,0,18,12,30
2023/4/15 15:10,1,25,0,0,25,15,40
2023/4/15 15:20,1,25,0,0,25,12,37
2023/4/15 15:30,1,25,0,0,29,14,43
2023/4/15 15:40,1,25,0,0,21,16,37
2023/4/15 15:50,1,26,0,0,29,18,47
2023/4/15 16:00,1,26,0,0,21,13,34
2023/4/15 16:10,1,26,0,0,25,18,43
2023/4/15 16:20,1,26,0,0,28,13,41
2023/4/15 16:30,1,26,0,0,26,11,37
2023/4/15 16:40,1,26,0,0,32,10,42
2023/4/15 16:50,1,26,0,0,29,15,44
2023/4/15 17:00,1,26,0,0,35,19,54
2023/4/15 17:10,1,27,0,0,30,19,49
2023/4/15 17:20,1,27,0,0,40,24,64
2023/4/15 17:30,1,27,0,0,38,27,65
2023/4/15 17:40,1,27,0,0,32,30,62
2023/4/15 17:50,1,27,0,0,39,31,70
2023/4/15 18:00,1,28,0,0,45,31,76
2023/4/15 18:10,1,28,0,0,46,34,80
2023/4/15 18:20,1,28,0,0,44,28,72
2023/4/15 18:30,1,28,0,0,36,27,63
2023/4/15 18:40,1,28,0,0,41,29,70
2023/4/15 18:50,1,28,0,0,41,31,72
2023/4/15 19:00,1,28,0,0,29,21,50
2023/4/15 19:10,1,28,0,0,28,23,51
2023/4/15 19:20,1,28,0,0,26,19,45
2023/4/15 19:30,1,28,0,0,25,18,43
2023/4/15 19:40,1,27,0,0,23,18,41
2023/4/15 19:50,1,27,0,0,21,18,39
2023/4/15 20:00,1,27,0,0,22,24,46
2023/4/15 20:10,1,26,0,0,18,19,37
2023/4/15 20:20,1,26,0,0,16,22,38
2023/4/15 20:30,1,26,0,0,17,31,48
2023/4/15 20:40,1,26,0,0,14,28,42
2023/4/15 20:50,1,26,0,0,13,32,45
2023/4/15 21:00,1,26,0,0,10,32,42
2023/4/15 21:10,1,25,0,0,13,27,40
2023/4/15 21:20,1,25,0,0,11,25,36
2023/4/15 21:30,1,25,0,0,8,23,31
2023/4/15 21:40,1,25,0,0,7,34,41
2023/4/15 21:50,1,25,0,0,10,39,49
2023/4/15 22:00,1,24,0,0,7,37,44
2023/4/15 22:10,1,24,0,0,3,30,33
2023/4/15 22:20,1,24,0,0,4,24,28
2023/4/15 22:30,1,24,0,0,1,18,19
2023/4/15 22:40,1,24,0,0,1,10,11
2023/4/15 22:50,1,24,0,0,4,11,15
2023/4/15 23:00,1,24,0,0,3,5,8
2023/4/15 23:10,1,24,0,0,1,6,7
2023/4/15 23:20,1,23,0,0,1,1,2
2023/4/15 23:30,1,23,0,0,0,2,2
2023/4/15 23:40,1,23,0,0,1,1,2
2023/4/15 23:50,1,23,0,0,1,2,3
2023/4/16 0:00,1,22,0,0,3,3,6
2023/4/16 0:10,1,22,0,0,2,1,3
2023/4/16 0:20,1,22,0,0,0,1,1
2023/4/16 0:30,1,22,0,0,2,0,2
2023/4/16 0:40,1,22,0,0,0,1,1
2023/4/16 0:50,1,22,0,0,1,2,3
2023/4/16 1:00,1,22,0,0,2,2,4
2023/4/16 1:10,1,22,0,0,1,1,2
2023/4/16 1:20,1,22,0,0,0,2,2
2023/4/16 1:30,1,21,0,0,2,1,3
2023/4/16 1:40,1,21,0,0,2,1,3
2023/4/16 1:50,1,21,0,0,0,0,0
2023/4/16 2:00,1,21,0,0,0,0,0
2023/4/16 2:10,1,21,0,0,0,1,1
2023/4/16 2:20,1,21,0,0,0,2,2
2023/4/16 2:30,1,21,0,0,1,2,3
2023/4/16 2:40,1,21,0,0,2,2,4
2023/4/16 2:50,1,21,0,0,0,1,1
2023/4/16 3:00,1,20,0,0,1,2,3
2023/4/16 3:10,1,20,0,0,0,0,0
2023/4/16 3:20,1,20,0,0,2,0,2
2023/4/16 3:30,1,20,0,0,0,2,2
2023/4/16 3:40,1,20,0,0,0,1,1
2023/4/16 3:50,1,20,0,0,0,1,1
2023/4/16 4:00,1,20,0,0,0,1,1
2023/4/16 4:10,1,20,0,0,2,0,2
2023/4/16 4:20,1,20,0,0,1,2,3
2023/4/16 4:30,1,20,0,0,2,2,4
2023/4/16 4:40,1,21,0,0,0,0,0
2023/4/16 4:50,1,21,0,0,1,0,1
2023/4/16 5:00,1,21,0,0,2,2,4
2023/4/16 5:10,1,21,0,0,2,1,3
2023/4/16 5:20,1,21,0,0,1,1,2
2023/4/16 5:30,1,21,0,0,2,2,4
2023/4/16 5:40,1,22,0,0,1,1,2
2023/4/16 5:50,1,22,0,0,3,0,3
2023/4/16 6:00,1,22,0,0,4,2,6
2023/4/16 6:10,1,22,0,0,8,0,8
2023/4/16 6:20,1,22,0,0,7,0,7
2023/4/16 6:30,1,22,0,0,10,3,13
2023/4/16 6:40,1,22,0,0,10,0,10
2023/4/16 6:50,1,22,0,0,8,4,12
2023/4/16 7:00,1,22,0,0,14,1,15
2023/4/16 7:10,1,22,0,0,18,3,21
2023/4/16 7:20,1,23,0,0,46,1,47
2023/4/16 7:30,1,23,0,0,55,5,60
2023/4/16 7:40,1,23,0,0,61,2,63
2023/4/16 7:50,1,24,0,0,48,3,51
2023/4/16 8:00,1,24,0,0,39,6,45
2023/4/16 8:10,1,24,0,0,35,4,39
2023/4/16 8:20,1,25,0,0,29,0,29
2023/4/16 8:30,1,25,0,0,33,1,34
2023/4/16 8:40,1,25,0,0,32,4,36
2023/4/16 8:50,1,26,0,0,35,4,39
2023/4/16 9:00,1,26,0,0,34,4,38
2023/4/16 9:10,1,26,0,0,35,5,40
2023/4/16 9:20,1,26,0,0,36,8,44
2023/4/16 9:30,1,26,0,0,31,15,46
2023/4/16 9:40,1,27,0,0,37,18,55
2023/4/16 9:50,1,27,0,0,40,10,50
2023/4/16 10:00,1,27,0,0,38,15,53
2023/4/16 10:10,1,28,0,0,26,13,39
2023/4/16 10:20,1,28,0,0,22,11,33
2023/4/16 10:30,1,28,0,0,23,13,36
2023/4/16 10:40,1,28,0,0,23,16,39
2023/4/16 10:50,1,28,0,0,17,18,35
2023/4/16 11:00,1,28,0,0,17,18,35
2023/4/16 11:10,1,28,0,0,17,19,36
2023/4/16 11:20,1,28,0,0,11,21,32
2023/4/16 11:30,1,29,0,0,16,22,38
2023/4/16 11:40,1,29,0,0,9,24,33
2023/4/16 11:50,1,29,0,0,10,33,43
2023/4/16 12:00,1,29,0,0,13,35,48
2023/4/16 12:10,1,29,0,0,16,32,48
2023/4/16 12:20,1,29,0,0,10,29,39
2023/4/16 12:30,1,29,0,0,13,26,39
2023/4/16 12:40,1,29,0,0,11,29,40
2023/4/16 12:50,1,30,0,0,10,23,33
2023/4/16 13:00,1,30,0,0,12,23,35
2023/4/16 13:10,1,30,0,0,11,21,32
2023/4/16 13:20,1,30,0,0,15,17,32
2023/4/16 13:30,1,30,0,0,16,16,32
2023/4/16 13:40,1,31,0,0,28,19,47
2023/4/16 13:50,1,31,0,0,21,17,38
2023/4/16 14:00,1,31,0,0,21,17,38
2023/4/16 14:10,1,31,0,0,16,22,38
2023/4/16 14:20,1,31,0,0,14,13,27
2023/4/16 14:30,1,32,0,0,13,18,31
2023/4/16 14:40,1,32,0,0,14,12,26
2023/4/16 14:50,1,32,0,0,15,15,30
2023/4/16 15:00,1,32,0,0,22,11,33
2023/4/16 15:10,1,32,0,0,23,11,34
2023/4/16 15:20,1,32,0,0,24,15,39
2023/4/16 15:30,1,32,0,0,29,14,43
2023/4/16 15:40,1,32,0,0,24,19,43
2023/4/16 15:50,1,31,0,0,29,14,43
2023/4/16 16:00,1,31,0,0,26,13,39
2023/4/16 16:10,1,31,0,0,24,14,38
2023/4/16 16:20,1,31,0,0,23,15,38
2023/4/16 16:30,1,31,0,0,33,14,47
2023/4/16 16:40,1,31,0,0,31,9,40
2023/4/16 16:50,1,31,0,0,29,17,46
2023/4/16 17:00,1,30,0,0,39,19,58
2023/4/16 17:10,1,30,0,0,32,22,54
2023/4/16 17:20,1,30,0,0,39,23,62
2023/4/16 17:30,1,30,0,0,31,21,52
2023/4/16 17:40,1,30,0,0,39,28,67
2023/4/16 17:50,1,30,0,0,42,32,74
2023/4/16 18:00,1,29,0,0,46,37,83
2023/4/16 18:10,1,29,0,0,37,34,71
2023/4/16 18:20,1,29,0,0,44,24,68
2023/4/16 18:30,1,29,0,0,40,30,70
2023/4/16 18:40,1,29,0,0,39,27,66
2023/4/16 18:50,1,28,0,0,41,25,66
2023/4/16 19:00,1,28,0,0,34,21,55
2023/4/16 19:10,1,28,0,0,32,19,51
2023/4/16 19:20,1,28,0,0,23,18,41
2023/4/16 19:30,1,28,0,0,22,18,40
2023/4/16 19:40,1,28,0,0,26,19,45
2023/4/16 19:50,1,27,0,0,24,15,39
2023/4/16 20:00,1,27,0,0,23,23,46
2023/4/16 20:10,1,27,0,0,18,23,41
2023/4/16 20:20,1,27,0,0,18,23,41
2023/4/16 20:30,1,27,0,0,17,32,49
2023/4/16 20:40,1,27,0,0,15,33,48
2023/4/16 20:50,1,27,0,0,13,30,43
2023/4/16 21:00,1,26,0,0,11,32,43
2023/4/16 21:10,1,26,0,0,16,25,41
2023/4/16 21:20,1,26,0,0,10,24,34
2023/4/16 21:30,1,26,0,0,12,26,38
2023/4/16 21:40,1,26,0,0,6,40,46
2023/4/16 21:50,1,25,0,0,9,41,50
2023/4/16 22:00,1,25,0,0,4,32,36
2023/4/16 22:10,1,25,0,0,5,31,36
2023/4/16 22:20,1,24,0,0,4,25,29
2023/4/16 22:30,1,24,0,0,2,19,21
2023/4/16 22:40,1,24,0,0,3,13,16
2023/4/16 22:50,1,24,0,0,3,10,13
2023/4/16 23:00,1,24,0,0,1,7,8
2023/4/16 23:10,1,24,0,0,1,6,7
2023/4/16 23:20,1,24,0,0,2,3,5
2023/4/16 23:30,1,24,0,0,2,1,3
2023/4/16 23:40,1,24,0,0,0,1,1
2023/4/16 23:50,1,23,0,0,1,1,2
2023/4/17 0:00,1,23,1,0,5,0,5
2023/4/17 0:10,1,23,1,0,4,0,4
2023/4/17 0:20,1,23,1,0,4,2,6
2023/4/17 0:30,1,23,1,0,0,1,1
2023/4/17 0:40,1,23,1,0,1,0,1
2023/4/17 0:50,1,23,1,0,0,1,1
2023/4/17 1:00,1,22,1,0,1,2,3
2023/4/17 1:10,1,22,1,0,2,1,3
2023/4/17 1:20,1,22,1,0,0,0,0
2023/4/17 1:30,1,22,1,0,1,2,3
2023/4/17 1:40,1,22,1,0,1,2,3
2023/4/17 1:50,1,22,1,0,1,0,1
2023/4/17 2:00,1,22,1,0,0,1,1
2023/4/17 2:10,1,22,1,0,1,2,3
2023/4/17 2:20,1,21,1,0,2,1,3
2023/4/17 2:30,1,21,1,0,2,0,2
2023/4/17 2:40,1,21,1,0,1,0,1
2023/4/17 2:50,1,21,1,0,2,0,2
2023/4/17 3:00,1,21,1,0,0,2,2
2023/4/17 3:10,1,21,1,0,2,2,4
2023/4/17 3:20,1,21,1,0,1,2,3
2023/4/17 3:30,1,21,1,0,0,2,2
2023/4/17 3:40,1,21,1,0,2,0,2
2023/4/17 3:50,1,21,1,0,0,2,2
2023/4/17 4:00,1,21,1,0,0,2,2
2023/4/17 4:10,1,21,1,0,1,2,3
2023/4/17 4:20,1,21,1,0,0,0,0
2023/4/17 4:30,1,21,1,0,0,2,2
2023/4/17 4:40,1,21,1,0,0,1,1
2023/4/17 4:50,1,21,1,0,2,2,4
2023/4/17 5:00,1,21,1,0,2,2,4
2023/4/17 5:10,1,21,1,0,1,2,3
2023/4/17 5:20,1,21,1,0,2,0,2
2023/4/17 5:30,1,22,1,0,1,1,2
2023/4/17 5:40,1,22,1,0,2,2,4
2023/4/17 5:50,1,22,1,0,3,2,5
2023/4/17 6:00,1,22,1,0,3,2,5
2023/4/17 6:10,1,22,1,0,2,3,5
2023/4/17 6:20,1,23,1,0,7,1,8
2023/4/17 6:30,1,23,1,0,5,2,7
2023/4/17 6:40,1,23,1,0,14,1,15
2023/4/17 6:50,1,23,1,0,41,1,42
2023/4/17 7:00,1,23,1,0,65,4,69
2023/4/17 7:10,1,23,1,0,86,0,86
2023/4/17 7:20,1,23,1,0,98,3,101
2023/4/17 7:30,1,24,1,0,310,1,311
2023/4/17 7:40,1,24,1,0,543,3,546
2023/4/17 7:50,1,24,1,0,646,4,650
2023/4/17 8:00,1,24,1,0,267,5,272
2023/4/17 8:10,1,24,1,0,155,12,167
2023/4/17 8:20,1,25,1,0,91,10,101
2023/4/17 8:30,1,25,1,0,85,11,96
2023/4/17 8:40,1,25,1,0,85,12,97
2023/4/17 8:50,1,25,1,0,68,14,82
2023/4/17 9:00,1,25,1,0,76,15,91
2023/4/17 9:10,1,25,1,0,93,15,108
2023/4/17 9:20,1,25,1,0,154,31,185
2023/4/17 9:30,1,26,1,0,196,37,233
2023/4/17 9:40,1,26,1,0,271,145,416
2023/4/17 9:50,1,26,1,0,189,172,361
2023/4/17 10:00,1,26,1,0,121,158,279
2023/4/17 10:10,1,26,1,0,89,103,192
2023/4/17 10:20,1,26,1,0,83,77,160
2023/4/17 10:30,1,27,1,0,66,50,116
2023/4/17 10:40,1,27,1,0,68,46,114
2023/4/17 10:50,1,27,1,0,65,46,111
2023/4/17 11:00,1,27,1,0,75,41,116
2023/4/17 11:10,1,28,1,0,64,36,100
2023/4/17 11:20,1,28,1,0,68,48,116
2023/4/17 11:30,1,28,1,0,67,62,129
2023/4/17 11:40,1,28,1,0,75,219,294
2023/4/17 11:50,1,29,1,0,60,262,322
2023/4/17 12:00,1,29,1,0,61,265,326
2023/4/17 12:10,1,29,1,0,59,173,232
2023/4/17 12:20,1,29,1,0,58,109,167
2023/4/17 12:30,1,29,1,0,61,86,147
2023/4/17 12:40,1,29,1,0,56,71,127
2023/4/17 12:50,1,30,1,0,58,57,115
2023/4/17 13:00,1,30,1,0,68,30,98
2023/4/17 13:10,1,30,1,0,70,31,101
2023/4/17 13:20,1,30,1,0,85,31,116
2023/4/17 13:30,1,30,1,0,145,30,175
2023/4/17 13:40,1,30,1,0,223,31,254
2023/4/17 13:50,1,30,1,0,216,42,258
2023/4/17 14:00,1,31,1,0,130,32,162
2023/4/17 14:10,1,31,1,0,117,38,155
2023/4/17 14:20,1,31,1,0,101,34,135
2023/4/17 14:30,1,31,1,0,82,38,120
2023/4/17 14:40,1,31,1,0,71,42,113
2023/4/17 14:50,1,31,1,0,65,42,107
2023/4/17 15:00,1,31,1,0,76,44,120
2023/4/17 15:10,1,31,1,0,84,40,124
2023/4/17 15:20,1,32,1,0,86,44,130
2023/4/17 15:30,1,32,1,0,75,74,149
2023/4/17 15:40,1,32,1,0,140,192,332
2023/4/17 15:50,1,32,1,0,173,210,383
2023/4/17 16:00,1,32,1,0,107,153,260
2023/4/17 16:10,1,32,1,0,97,104,201
2023/4/17 16:20,1,32,1,0,77,88,165
2023/4/17 16:30,1,33,1,0,71,72,143
2023/4/17 16:40,1,33,1,0,79,53,132
2023/4/17 16:50,1,33,1,0,67,57,124
2023/4/17 17:00,1,33,1,0,75,64,139
2023/4/17 17:10,1,33,1,0,72,50,122
2023/4/17 17:20,1,33,1,0,76,60,136
2023/4/17 17:30,1,33,1,0,82,83,165
2023/4/17 17:40,1,33,1,0,81,224,305
2023/4/17 17:50,1,33,1,0,85,245,330
2023/4/17 18:00,1,33,1,0,93,224,317
2023/4/17 18:10,1,32,1,0,86,128,214
2023/4/17 18:20,1,32,1,0,84,99,183
2023/4/17 18:30,1,32,1,0,122,76,198
2023/4/17 18:40,1,31,1,0,201,70,271
2023/4/17 18:50,1,31,1,0,164,78,242
2023/4/17 19:00,1,31,1,0,149,62,211
2023/4/17 19:10,1,31,1,0,114,69,183
2023/4/17 19:20,1,31,1,0,93,59,152
2023/4/17 19:30,1,31,1,0,84,66,150
2023/4/17 19:40,1,30,1,0,80,54,134
2023/4/17 19:50,1,30,1,0,86,63,149
2023/4/17 20:00,1,30,1,0,90,71,161
2023/4/17 20:10,1,30,1,0,89,67,156
2023/4/17 20:20,1,30,1,0,71,59,130
2023/4/17 20:30,1,30,1,0,58,101,159
2023/4/17 20:40,1,30,1,0,73,217,290
2023/4/17 20:50,1,30,1,0,48,221,269
2023/4/17 21:00,1,29,1,0,46,173,219
2023/4/17 21:10,1,29,1,0,54,141,195
2023/4/17 21:20,1,29,1,0,30,114,144
2023/4/17 21:30,1,29,1,0,21,61,82
2023/4/17 21:40,1,28,1,0,18,77,95
2023/4/17 21:50,1,28,1,0,19,88,107
2023/4/17 22:00,1,28,1,0,16,75,91
2023/4/17 22:10,1,28,1,0,13,82,95
2023/4/17 22:20,1,28,1,0,15,45,60
2023/4/17 22:30,1,28,1,0,13,37,50
2023/4/17 22:40,1,28,1,0,10,20,30
2023/4/17 22:50,1,28,1,0,8,12,20
2023/4/17 23:00,1,28,1,0,10,11,21
2023/4/17 23:10,1,27,1,0,7,13,20
2023/4/17 23:20,1,27,1,0,7,8,15
2023/4/17 23:30,1,27,1,0,2,7,9
2023/4/17 23:40,1,26,1,0,3,10,13
2023/4/17 23:50,1,26,1,0,1,5,6
2023/4/18 0:00,1,26,1,0,3,0,3
2023/4/18 0:10,1,26,1,0,2,2,4
2023/4/18 0:20,1,26,1,0,4,1,5
2023/4/18 0:30,1,25,1,0,2,2,4
2023/4/18 0:40,1,25,1,0,1,2,3
2023/4/18 0:50,1,25,1,0,0,2,2
2023/4/18 1:00,1,25,1,0,0,2,2
2023/4/18 1:10,1,24,1,0,2,1,3
2023/4/18 1:20,1,24,1,0,2,0,2
2023/4/18 1:30,1,24,1,0,1,0,1
2023/4/18 1:40,1,24,1,0,0,1,1
2023/4/18 1:50,1,24,1,0,2,0,2
2023/4/18 2:00,1,24,1,0,1,1,2
2023/4/18 2:10,1,23,1,0,0,0,0
2023/4/18 2:20,1,22,1,0,0,0,0
2023/4/18 2:30,1,22,1,0,1,1,2
2023/4/18 2:40,1,22,1,0,0,0,0
2023/4/18 2:50,1,21,1,0,0,2,2
2023/4/18 3:00,1,21,1,0,2,0,2
2023/4/18 3:10,1,21,1,0,2,2,4
2023/4/18 3:20,1,21,1,0,0,0,0
2023/4/18 3:30,1,21,1,0,2,0,2
2023/4/18 3:40,1,21,1,0,0,0,0
2023/4/18 3:50,1,20,1,0,0,0,0
2023/4/18 4:00,1,20,1,0,2,2,4
2023/4/18 4:10,1,20,1,0,0,1,1
2023/4/18 4:20,1,20,1,0,2,1,3
2023/4/18 4:30,1,20,1,0,1,1,2
2023/4/18 4:40,1,20,1,0,1,2,3
2023/4/18 4:50,1,20,1,0,2,1,3
2023/4/18 5:00,1,20,1,0,0,1,1
2023/4/18 5:10,1,20,1,0,1,1,2
2023/4/18 5:20,1,20,1,0,1,2,3
2023/4/18 5:30,1,20,1,0,3,0,3
2023/4/18 5:40,1,20,1,0,1,0,1
2023/4/18 5:50,1,20,1,0,5,1,6
2023/4/18 6:00,1,20,1,0,3,2,5
2023/4/18 6:10,1,20,1,0,4,2,6
2023/4/18 6:20,1,20,1,0,7,3,10
2023/4/18 6:30,1,20,1,0,7,2,9
2023/4/18 6:40,1,20,1,0,10,0,10
2023/4/18 6:50,1,20,1,0,35,2,37
2023/4/18 7:00,1,20,1,0,61,3,64
2023/4/18 7:10,1,20,1,0,88,2,90
2023/4/18 7:20,1,20,1,0,99,1,100
2023/4/18 7:30,1,20,1,0,344,0,344
2023/4/18 7:40,1,21,1,0,526,3,529
2023/4/18 7:50,1,21,1,0,604,6,610
2023/4/18 8:00,1,21,1,0,301,5,306
2023/4/18 8:10,1,21,1,0,147,12,159
2023/4/18 8:20,1,21,1,0,85,11,96
2023/4/18 8:30,1,21,1,0,93,13,106
2023/4/18 8:40,1,21,1,0,77,14,91
2023/4/18 8:50,1,21,1,0,67,14,81
2023/4/18 9:00,1,21,1,0,83,14,97
2023/4/18 9:10,1,21,1,0,87,17,104
2023/4/18 9:20,1,21,1,0,155,26,181
2023/4/18 9:30,1,21,1,0,224,40,264
2023/4/18 9:40,1,21,1,0,232,141,373
2023/4/18 9:50,1,21,1,0,167,184,351
2023/4/18 10:00,1,21,1,0,147,133,280
2023/4/18 10:10,1,21,1,0,80,107,187
2023/4/18 10:20,1,21,1,0,70,75,145
2023/4/18 10:30,1,21,1,0,58,54,112
2023/4/18 10:40,1,21,1,0,57,49,106
2023/4/18 10:50,1,21,1,0,64,45,109
2023/4/18 11:00,1,21,1,0,73,39,112
2023/4/18 11:10,1,21,1,0,54,33,87
2023/4/18 11:20,1,21,1,0,60,47,107
2023/4/18 11:30,1,21,1,0,62,72,134
2023/4/18 11:40,1,21,1,0,72,228,300
2023/4/18 11:50,1,21,1,0,65,290,355
2023/4/18 12:00,1,21,1,0,65,287,352
2023/4/18 12:10,1,21,1,0,58,198,256
2023/4/18 12:20,1,21,1,0,59,106,165
2023/4/18 12:30,1,21,1,0,67,75,142
2023/4/18 12:40,1,21,1,0,60,65,125
2023/4/18 12:50,1,21,1,0,58,55,113
2023/4/18 13:00,1,22,1,0,58,34,92
2023/4/18 13:10,1,22,1,0,61,34,95
2023/4/18 13:20,1,22,1,0,98,35,133
2023/4/18 13:30,1,22,1,0,181,32,213
2023/4/18 13:40,1,22,1,0,236,31,267
2023/4/18 13:50,1,22,1,0,247,41,288
2023/4/18 14:00,1,22,1,0,135,30,165
2023/4/18 14:10,1,22,1,0,102,41,143
2023/4/18 14:20,1,22,1,0,89,36,125
2023/4/18 14:30,1,22,1,0,82,46,128
2023/4/18 14:40,1,22,1,0,77,47,124
2023/4/18 14:50,1,22,1,0,63,38,101
2023/4/18 15:00,1,22,1,0,78,43,121
2023/4/18 15:10,1,22,1,0,77,43,120
2023/4/18 15:20,1,22,1,0,74,46,120
2023/4/18 15:30,1,22,1,0,92,65,157
2023/4/18 15:40,1,22,1,0,136,169,305
2023/4/18 15:50,1,22,1,0,173,240,413
2023/4/18 16:00,1,22,1,0,101,142,243
2023/4/18 16:10,1,22,1,0,84,108,192
2023/4/18 16:20,1,22,1,0,85,83,168
2023/4/18 16:30,1,22,1,0,78,63,141
2023/4/18 16:40,1,22,1,0,75,59,134
2023/4/18 16:50,1,22,1,0,78,59,137
2023/4/18 17:00,1,22,1,0,79,62,141
2023/4/18 17:10,1,22,1,0,75,56,131
2023/4/18 17:20,1,22,1,0,87,48,135
2023/4/18 17:30,1,22,1,0,72,87,159
2023/4/18 17:40,1,22,1,0,80,226,306
2023/4/18 17:50,1,22,1,0,108,252,360
2023/4/18 18:00,1,22,1,0,87,181,268
2023/4/18 18:10,1,22,1,0,97,137,234
2023/4/18 18:20,1,22,1,0,99,92,191
2023/4/18 18:30,1,22,1,0,128,92,220
2023/4/18 18:40,1,22,1,0,188,71,259
2023/4/18 18:50,1,22,1,0,188,62,250
2023/4/18 19:00,1,22,1,0,124,60,184
2023/4/18 19:10,1,22,1,0,129,64,193
2023/4/18 19:20,1,22,1,0,92,56,148
2023/4/18 19:30,1,22,1,0,81,67,148
2023/4/18 19:40,1,22,1,0,81,51,132
2023/4/18 19:50,1,22,1,0,91,69,160
2023/4/18 20:00,1,22,1,0,81,67,148
2023/4/18 20:10,1,22,1,0,83,56,139
2023/4/18 20:20,1,22,1,0,86,56,142
2023/4/18 20:30,1,22,1,0,71,97,168
2023/4/18 20:40,1,21,1,0,62,197,259
2023/4/18 20:50,1,21,1,0,48,216,264
2023/4/18 21:00,1,21,1,0,53,151,204
2023/4/18 21:10,1,21,1,0,55,124,179
2023/4/18 21:20,1,21,1,0,31,100,131
2023/4/18 21:30,1,21,1,0,22,66,88
2023/4/18 21:40,1,21,1,0,19,77,96
2023/4/18 21:50,1,21,1,0,15,90,105
2023/4/18 22:00,1,21,1,0,14,93,107
2023/4/18 22:10,1,21,1,0,13,65,78
2023/4/18 22:20,1,21,1,0,16,45,61
2023/4/18 22:30,1,21,1,0,14,35,49
2023/4/18 22:40,1,21,1,0,9,20,29
2023/4/18 22:50,1,21,1,0,11,14,25
2023/4/18 23:00,1,21,1,0,8,12,20
2023/4/18 23:10,1,21,1,0,5,14,19
2023/4/18 23:20,1,21,1,0,4,11,15
2023/4/18 23:30,1,20,1,0,3,7,10
2023/4/18 23:40,1,20,1,0,3,9,12
2023/4/18 23:50,1,20,1,0,1,3,4
2023/4/19 0:00,1,20,1,0,4,1,5
2023/4/19 0:10,1,20,1,0,4,2,6
2023/4/19 0:20,1,20,1,0,3,3,6
2023/4/19 0:30,1,20,1,0,0,0,0
2023/4/19 0:40,1,20,1,0,2,2,4
2023/4/19 0:50,1,20,1,0,0,2,2
2023/4/19 1:00,1,20,1,0,2,0,2
2023/4/19 1:10,1,20,1,0,2,1,3
2023/4/19 1:20,1,20,1,0,2,2,4
2023/4/19 1:30,1,20,1,0,0,2,2
2023/4/19 1:40,1,20,1,0,1,2,3
2023/4/19 1:50,1,20,1,0,2,1,3
2023/4/19 2:00,1,20,1,0,0,1,1
2023/4/19 2:10,1,20,1,0,0,0,0
2023/4/19 2:20,1,20,1,0,0,2,2
2023/4/19 2:30,1,20,1,0,0,1,1
2023/4/19 2:40,1,20,1,0,0,1,1
2023/4/19 2:50,1,20,1,0,0,1,1
2023/4/19 3:00,1,20,1,0,1,0,1
2023/4/19 3:10,1,20,1,0,0,1,1
2023/4/19 3:20,1,20,1,0,0,1,1
2023/4/19 3:30,1,20,1,0,2,2,4
2023/4/19 3:40,1,20,1,0,1,0,1
2023/4/19 3:50,1,20,1,0,1,2,3
2023/4/19 4:00,1,20,1,0,1,0,1
2023/4/19 4:10,1,20,1,0,1,2,3
2023/4/19 4:20,1,20,1,0,2,0,2
2023/4/19 4:30,1,20,1,0,1,0,1
2023/4/19 4:40,1,20,1,0,2,1,3
2023/4/19 4:50,1,20,1,0,0,2,2
2023/4/19 5:00,1,20,1,0,0,0,0
2023/4/19 5:10,1,20,1,0,0,1,1
2023/4/19 5:20,1,20,1,0,1,1,2
2023/4/19 5:30,1,21,1,0,3,0,3
2023/4/19 5:40,1,21,1,0,2,2,4
2023/4/19 5:50,1,21,1,0,5,1,6
2023/4/19 6:00,1,21,1,0,2,3,5
2023/4/19 6:10,1,21,1,0,2,3,5
2023/4/19 6:20,1,21,1,0,4,2,6
2023/4/19 6:30,1,21,1,0,7,3,10
2023/4/19 6:40,1,21,1,0,14,1,15
2023/4/19 6:50,1,21,1,0,39,0,39
2023/4/19 7:00,1,22,1,0,57,4,61
2023/4/19 7:10,1,22,1,0,101,2,103
2023/4/19 7:20,1,22,1,0,98,3,101
2023/4/19 7:30,1,22,1,0,347,0,347
2023/4/19 7:40,1,22,1,0,611,5,616
2023/4/19 7:50,1,22,1,0,603,6,609
2023/4/19 8:00,1,22,1,0,299,5,304
2023/4/19 8:10,1,22,1,0,124,12,136
2023/4/19 8:20,1,22,1,0,86,10,96
2023/4/19 8:30,1,23,1,0,74,11,85
2023/4/19 8:40,1,23,1,0,73,12,85
2023/4/19 8:50,1,23,1,0,81,10,91
2023/4/19 9:00,1,23,1,0,85,13,98
2023/4/19 9:10,1,23,1,0,95,18,113
2023/4/19 9:20,1,23,1,0,133,27,160
2023/4/19 9:30,1,23,1,0,197,37,234
2023/4/19 9:40,1,23,1,0,266,119,385
2023/4/19 9:50,1,23,1,0,202,162,364
2023/4/19 10:00,1,23,1,0,149,141,290
2023/4/19 10:10,1,23,1,0,86,92,178
2023/4/19 10:20,1,23,1,0,72,73,145
2023/4/19 10:30,1,23,1,0,63,52,115
2023/4/19 10:40,1,24,1,0,67,49,116
2023/4/19 10:50,1,24,1,0,68,37,105
2023/4/19 11:00,1,24,1,0,63,38,101
2023/4/19 11:10,1,24,1,0,56,42,98
2023/4/19 11:20,1,25,1,0,59,41,100
2023/4/19 11:30,1,25,1,0,62,63,125
2023/4/19 11:40,1,25,1,0,68,233,301
2023/4/19 11:50,1,25,1,0,74,293,367
2023/4/19 12:00,1,25,1,0,64,238,302
2023/4/19 12:10,1,25,1,0,49,194,243
2023/4/19 12:20,1,25,1,0,62,117,179
2023/4/19 12:30,1,25,1,0,40,95,135
2023/4/19 12:40,1,26,1,0,30,69,99
2023/4/19 12:50,1,26,1,0,19,44,63
2023/4/19 13:00,1,26,1,0,16,34,50
2023/4/19 13:10,1,26,1,0,13,21,34
2023/4/19 13:20,1,26,1,0,17,16,33
2023/4/19 13:30,1,26,1,0,16,15,31
2023/4/19 13:40,1,26,1,0,28,23,51
2023/4/19 13:50,1,26,1,0,27,24,51
2023/4/19 14:00,1,27,1,0,27,20,47
2023/4/19 14:10,1,27,1,0,21,22,43
2023/4/19 14:20,1,27,1,0,21,20,41
2023/4/19 14:30,1,27,1,0,19,22,41
2023/4/19 14:40,1,28,1,0,19,15,34
2023/4/19 14:50,1,28,1,0,22,16,38
2023/4/19 15:00,1,28,1,0,22,11,33
2023/4/19 15:10,1,28,1,0,27,14,41
2023/4/19 15:20,1,28,1,0,30,17,47
2023/4/19 15:30,1,28,1,0,32,19,51
2023/4/19 15:40,1,28,1,0,29,24,53
2023/4/19 15:50,1,28,1,0,37,17,54
2023/4/19 16:00,1,28,1,0,26,16,42
2023/4/19 16:10,1,28,1,0,31,20,51
2023/4/19 16:20,1,28,1,0,34,15,49
2023/4/19 16:30,1,28,1,0,32,16,48
2023/4/19 16:40,1,28,1,0,32,14,46
2023/4/19 16:50,1,28,1,0,45,17,62
2023/4/19 17:00,1,28,1,0,46,22,68
2023/4/19 17:10,1,28,1,0,38,21,59
2023/4/19 17:20,1,28,1,0,47,23,70
2023/4/19 17:30,1,28,1,0,45,33,78
2023/4/19 17:40,1,28,1,0,45,36,81
2023/4/19 17:50,1,28,1,0,51,39,90
2023/4/19 18:00,1,28,1,0,53,43,96
2023/4/19 18:10,1,27,1,0,46,33,79
2023/4/19 18:20,1,27,1,0,59,28,87
2023/4/19 18:30,1,27,1,0,55,38,93
2023/4/19 18:40,1,27,1,0,44,28,72
2023/4/19 18:50,1,27,1,0,42,36,78
2023/4/19 19:00,1,27,1,0,42,28,70
2023/4/19 19:10,1,26,1,0,39,21,60
2023/4/19 19:20,1,26,1,0,31,24,55
2023/4/19 19:30,1,26,1,0,25,23,48
2023/4/19 19:40,1,26,1,0,27,21,48
2023/4/19 19:50,1,26,1,0,22,20,42
2023/4/19 20:00,1,26,1,0,26,26,52
2023/4/19 20:10,1,25,1,0,24,23,47
2023/4/19 20:20,1,25,1,0,21,25,46
2023/4/19 20:30,1,25,1,0,18,36,54
2023/4/19 20:40,1,25,1,0,20,41,61
2023/4/19 20:50,1,25,1,0,15,36,51
2023/4/19 21:00,1,25,1,0,15,46,61
2023/4/19 21:10,1,25,1,0,15,35,50
2023/4/19 21:20,1,25,1,0,13,26,39
2023/4/19 21:30,1,24,1,0,14,27,41
2023/4/19 21:40,1,24,1,0,9,43,52
2023/4/19 21:50,1,24,1,0,8,44,52
2023/4/19 22:00,1,24,1,0,5,45,50
2023/4/19 22:10,1,24,1,0,3,34,37
2023/4/19 22:20,1,24,1,0,3,33,36
2023/4/19 22:30,1,24,1,0,2,23,25
2023/4/19 22:40,1,24,1,0,3,13,16
2023/4/19 22:50,1,24,1,0,3,12,15
2023/4/19 23:00,1,24,1,0,3,6,9
2023/4/19 23:10,1,23,1,0,2,5,7
2023/4/19 23:20,1,23,1,0,2,1,3
2023/4/19 23:30,1,23,1,0,2,2,4
2023/4/19 23:40,1,23,1,0,1,1,2
2023/4/19 23:50,1,23,1,0,2,0,2
2023/4/20 0:00,1,23,1,0,4,2,6
2023/4/20 0:10,1,23,1,0,2,0,2
2023/4/20 0:20,1,23,1,0,3,2,5
2023/4/20 0:30,1,22,1,0,1,0,1
2023/4/20 0:40,1,22,1,0,3,1,4
2023/4/20 0:50,1,22,1,0,0,2,2
2023/4/20 1:00,1,22,1,0,1,0,1
2023/4/20 1:10,1,22,1,0,2,2,4
2023/4/20 1:20,1,22,1,0,0,0,0
2023/4/20 1:30,1,22,1,0,2,2,4
2023/4/20 1:40,1,22,1,0,1,1,2
2023/4/20 1:50,1,22,1,0,0,2,2
2023/4/20 2:00,1,21,1,0,2,1,3
2023/4/20 2:10,1,21,1,0,2,2,4
2023/4/20 2:20,1,21,1,0,2,0,2
2023/4/20 2:30,1,21,1,0,2,2,4
2023/4/20 2:40,1,21,1,0,0,1,1
2023/4/20 2:50,1,20,1,0,2,1,3
2023/4/20 3:00,1,20,1,0,0,0,0
2023/4/20 3:10,1,20,1,0,1,2,3
2023/4/20 3:20,1,20,1,0,2,2,4
2023/4/20 3:30,1,20,1,0,2,2,4
2023/4/20 3:40,1,20,1,0,2,0,2
2023/4/20 3:50,1,20,1,0,2,0,2
2023/4/20 4:00,1,20,1,0,2,2,4
2023/4/20 4:10,1,20,1,0,2,0,2
2023/4/20 4:20,1,20,1,0,0,1,1
2023/4/20 4:30,1,21,1,0,0,0,0
2023/4/20 4:40,1,21,1,0,2,0,2
2023/4/20 4:50,1,21,1,0,1,1,2
2023/4/20 5:00,1,21,1,0,2,1,3
2023/4/20 5:10,1,21,1,0,2,0,2
2023/4/20 5:20,1,22,1,0,1,1,2
2023/4/20 5:30,1,22,1,0,1,0,1
2023/4/20 5:40,1,22,1,0,2,2,4
2023/4/20 5:50,1,22,1,0,5,0,5
2023/4/20 6:00,1,22,1,0,3,3,6
2023/4/20 6:10,1,22,1,0,3,2,5
2023/4/20 6:20,1,23,1,0,7,2,9
2023/4/20 6:30,1,23,1,0,4,4,8
2023/4/20 6:40,1,23,1,0,12,1,13
2023/4/20 6:50,1,23,1,0,40,1,41
2023/4/20 7:00,1,23,1,0,59,3,62
2023/4/20 7:10,1,23,1,0,88,1,89
2023/4/20 7:20,1,24,1,0,98,3,101
2023/4/20 7:30,1,24,1,0,290,0,290
2023/4/20 7:40,1,24,1,0,527,4,531
2023/4/20 7:50,1,24,1,0,534,4,538
2023/4/20 8:00,1,24,1,0,274,8,282
2023/4/20 8:10,1,24,1,0,147,8,155
2023/4/20 8:20,1,24,1,0,86,10,96
2023/4/20 8:30,1,24,1,0,78,13,91
2023/4/20 8:40,1,24,1,0,74,14,88
2023/4/20 8:50,1,25,1,0,79,11,90
2023/4/20 9:00,1,25,1,0,84,14,98
2023/4/20 9:10,1,26,1,0,94,15,109
2023/4/20 9:20,1,26,1,0,144,32,176
2023/4/20 9:30,1,26,1,0,201,46,247
2023/4/20 9:40,1,26,1,0,268,122,390
2023/4/20 9:50,1,26,1,0,186,196,382
2023/4/20 10:00,1,26,1,0,118,145,263
2023/4/20 10:10,1,27,1,0,81,106,187
2023/4/20 10:20,1,27,1,0,78,67,145
2023/4/20 10:30,1,27,1,0,58,44,102
2023/4/20 10:40,1,27,1,0,64,45,109
2023/4/20 10:50,1,28,1,0,76,40,116
2023/4/20 11:00,1,28,1,0,63,35,98
2023/4/20 11:10,1,28,1,0,66,33,99
2023/4/20 11:20,1,28,1,0,56,51,107
2023/4/20 11:30,1,28,1,0,75,75,150
2023/4/20 11:40,1,28,1,0,73,198,271
2023/4/20 11:50,1,29,1,0,71,264,335
2023/4/20 12:00,1,29,1,0,65,263,328
2023/4/20 12:10,1,29,1,0,61,178,239
2023/4/20 12:20,1,29,1,0,64,111,175
2023/4/20 12:30,1,30,1,0,70,97,167
2023/4/20 12:40,1,30,1,0,57,60,117
2023/4/20 12:50,1,30,1,0,65,49,114
2023/4/20 13:00,1,30,1,0,56,28,84
2023/4/20 13:10,1,30,1,0,57,34,91
2023/4/20 13:20,1,31,1,0,91,34,125
2023/4/20 13:30,1,31,1,0,179,37,216
2023/4/20 13:40,1,31,1,0,238,35,273
2023/4/20 13:50,1,31,1,0,231,32,263
2023/4/20 14:00,1,31,1,0,132,33,165
2023/4/20 14:10,1,31,1,0,108,38,146
2023/4/20 14:20,1,31,1,0,111,38,149
2023/4/20 14:30,1,31,1,0,93,39,132
2023/4/20 14:40,1,30,1,0,88,44,132
2023/4/20 14:50,1,30,1,0,71,40,111
2023/4/20 15:00,1,30,1,0,66,49,115
2023/4/20 15:10,1,30,1,0,70,38,108
2023/4/20 15:20,1,30,1,0,86,38,124
2023/4/20 15:30,1,30,1,0,80,70,150
2023/4/20 15:40,1,30,1,0,138,181,319
2023/4/20 15:50,1,30,1,0,158,206,364
2023/4/20 16:00,1,29,1,0,98,164,262
2023/4/20 16:10,1,29,1,0,91,125,216
2023/4/20 16:20,1,29,1,0,84,84,168
2023/4/20 16:30,1,29,1,0,71,60,131
2023/4/20 16:40,1,29,1,0,66,63,129
2023/4/20 16:50,1,29,1,0,74,61,135
2023/4/20 17:00,1,28,1,0,73,64,137
2023/4/20 17:10,1,28,1,0,62,62,124
2023/4/20 17:20,1,28,1,0,68,52,120
2023/4/20 17:30,1,28,1,0,73,89,162
2023/4/20 17:40,1,28,1,0,80,245,325
2023/4/20 17:50,1,28,1,0,105,226,331
2023/4/20 18:00,1,27,1,0,92,215,307
2023/4/20 18:10,1,27,1,0,94,139,233
2023/4/20 18:20,1,27,1,0,94,88,182
2023/4/20 18:30,1,27,1,0,124,89,213
2023/4/20 18:40,1,27,1,0,172,80,252
2023/4/20 18:50,1,26,1,0,148,66,214
2023/4/20 19:00,1,26,1,0,146,56,202
2023/4/20 19:10,1,26,1,0,117,55,172
2023/4/20 19:20,1,26,1,0,104,69,173
2023/4/20 19:30,1,26,1,0,98,58,156
2023/4/20 19:40,1,26,1,0,84,60,144
2023/4/20 19:50,1,26,1,0,90,71,161
2023/4/20 20:00,1,26,1,0,86,62,148
2023/4/20 20:10,1,26,1,0,78,54,132
2023/4/20 20:20,1,25,1,0,78,55,133
2023/4/20 20:30,1,25,1,0,58,104,162
2023/4/20 20:40,1,25,1,0,73,189,262
2023/4/20 20:50,1,25,1,0,57,238,295
2023/4/20 21:00,1,25,1,0,49,154,203
2023/4/20 21:10,1,24,1,0,46,123,169
2023/4/20 21:20,1,24,1,0,33,113,146
2023/4/20 21:30,1,24,1,0,26,64,90
2023/4/20 21:40,1,24,1,0,18,66,84
2023/4/20 21:50,1,24,1,0,18,84,102
2023/4/20 22:00,1,24,1,0,18,88,106
2023/4/20 22:10,1,24,1,0,13,84,97
2023/4/20 22:20,1,23,1,0,14,49,63
2023/4/20 22:30,1,23,1,0,14,33,47
2023/4/20 22:40,1,23,1,0,11,23,34
2023/4/20 22:50,1,23,1,0,12,15,27
2023/4/20 23:00,1,23,1,0,11,14,25
2023/4/20 23:10,1,22,1,0,5,13,18
2023/4/20 23:20,1,22,1,0,4,8,12
2023/4/20 23:30,1,22,1,0,2,10,12
2023/4/20 23:40,1,22,1,0,3,8,11
2023/4/20 23:50,1,22,1,0,2,6,8
2023/4/21 0:00,1,22,1,0,3,0,3
2023/4/21 0:10,1,22,1,0,4,2,6
2023/4/21 0:20,1,22,1,0,4,2,6
2023/4/21 0:30,1,22,1,0,2,2,4
2023/4/21 0:40,1,21,1,0,1,2,3
2023/4/21 0:50,1,21,1,0,2,2,4
2023/4/21 1:00,1,21,1,0,1,1,2
2023/4/21 1:10,1,20,1,0,2,0,2
2023/4/21 1:20,1,20,1,0,2,0,2
2023/4/21 1:30,1,20,1,0,2,2,4
2023/4/21 1:40,1,20,1,0,1,2,3
2023/4/21 1:50,1,20,1,0,2,2,4
2023/4/21 2:00,1,20,1,0,0,0,0
2023/4/21 2:10,1,19,1,0,0,2,2
2023/4/21 2:20,1,19,1,0,0,0,0
2023/4/21 2:30,1,19,1,0,1,2,3
2023/4/21 2:40,1,19,1,0,2,2,4
2023/4/21 2:50,1,18,1,0,2,0,2
2023/4/21 3:00,1,18,1,0,0,1,1
2023/4/21 3:10,1,18,1,0,0,1,1
2023/4/21 3:20,1,17,1,0,1,2,3
2023/4/21 3:30,1,17,1,0,1,0,1
2023/4/21 3:40,1,17,1,0,2,0,2
2023/4/21 3:50,1,17,1,0,1,2,3
2023/4/21 4:00,1,17,1,0,0,0,0
2023/4/21 4:10,1,17,1,0,0,2,2
2023/4/21 4:20,1,18,1,0,2,0,2
2023/4/21 4:30,1,18,1,0,2,0,2
2023/4/21 4:40,1,18,1,0,2,0,2
2023/4/21 4:50,1,18,1,0,2,2,4
2023/4/21 5:00,1,18,1,0,0,0,0
2023/4/21 5:10,1,19,1,0,1,1,2
2023/4/21 5:20,1,19,1,0,2,0,2
2023/4/21 5:30,1,19,1,0,2,2,4
2023/4/21 5:40,1,19,1,0,1,1,2
2023/4/21 5:50,1,19,1,0,3,1,4
2023/4/21 6:00,1,20,1,0,3,4,7
2023/4/21 6:10,1,21,1,0,4,1,5
2023/4/21 6:20,1,22,1,0,7,3,10
2023/4/21 6:30,1,22,1,0,6,3,9
2023/4/21 6:40,1,22,1,0,14,2,16
2023/4/21 6:50,1,22,1,0,35,1,36
2023/4/21 7:00,1,22,1,0,66,3,69
2023/4/21 7:10,1,23,1,0,100,2,102
2023/4/21 7:20,1,23,1,0,101,3,104
2023/4/21 7:30,1,23,1,0,279,1,280
2023/4/21 7:40,1,23,1,0,615,4,619
2023/4/21 7:50,1,23,1,0,638,3,641
2023/4/21 8:00,1,24,1,0,258,5,263
2023/4/21 8:10,1,25,1,0,132,9,141
2023/4/21 8:20,1,25,1,0,93,9,102
2023/4/21 8:30,1,25,1,0,87,14,101
2023/4/21 8:40,1,25,1,0,75,16,91
2023/4/21 8:50,1,25,1,0,76,10,86
2023/4/21 9:00,1,26,1,0,81,15,96
2023/4/21 9:10,1,27,1,0,86,18,104
2023/4/21 9:20,1,27,1,0,164,30,194
2023/4/21 9:30,1,27,1,0,218,37,255
2023/4/21 9:40,1,27,1,0,231,133,364
2023/4/21 9:50,1,28,1,0,188,176,364
2023/4/21 10:00,1,28,1,0,120,138,258
2023/4/21 10:10,1,28,1,0,91,95,186
2023/4/21 10:20,1,28,1,0,87,65,152
2023/4/21 10:30,1,28,1,0,65,48,113
2023/4/21 10:40,1,28,1,0,64,43,107
2023/4/21 10:50,1,29,1,0,64,42,106
2023/4/21 11:00,1,29,1,0,62,36,98
2023/4/21 11:10,1,29,1,0,69,42,111
2023/4/21 11:20,1,30,1,0,64,39,103
2023/4/21 11:30,1,30,1,0,75,66,141
2023/4/21 11:40,1,30,1,0,76,198,274
2023/4/21 11:50,1,30,1,0,64,296,360
2023/4/21 12:00,1,30,1,0,59,272,331
2023/4/21 12:10,1,31,1,0,52,174,226
2023/4/21 12:20,1,31,1,0,63,116,179
2023/4/21 12:30,1,31,1,0,67,91,158
2023/4/21 12:40,1,31,1,0,58,60,118
2023/4/21 12:50,1,31,1,0,54,46,100
2023/4/21 13:00,1,31,1,0,65,29,94
2023/4/21 13:10,1,31,1,0,60,32,92
2023/4/21 13:20,1,31,1,0,79,36,115
2023/4/21 13:30,1,31,1,0,157,31,188
2023/4/21 13:40,1,31,1,0,224,38,262
2023/4/21 13:50,1,31,1,0,224,42,266
2023/4/21 14:00,1,31,1,0,113,30,143
2023/4/21 14:10,1,30,1,0,116,40,156
2023/4/21 14:20,1,30,1,0,90,39,129
2023/4/21 14:30,1,30,1,0,97,40,137
2023/4/21 14:40,1,30,1,0,88,47,135
2023/4/21 14:50,1,29,1,0,73,41,114
2023/4/21 15:00,1,29,1,0,65,40,105
2023/4/21 15:10,1,29,1,0,66,41,107
2023/4/21 15:20,1,29,1,0,67,36,103
2023/4/21 15:30,1,29,1,0,78,58,136
2023/4/21 15:40,1,28,1,0,148,157,305
2023/4/21 15:50,1,28,1,0,169,203,372
2023/4/21 16:00,1,28,1,0,99,130,229
2023/4/21 16:10,1,28,1,0,94,131,225
2023/4/21 16:20,1,28,1,0,84,72,156
2023/4/21 16:30,1,27,1,0,82,75,157
2023/4/21 16:40,1,27,1,0,80,53,133
2023/4/21 16:50,1,26,1,0,65,56,121
2023/4/21 17:00,1,26,1,0,77,53,130
2023/4/21 17:10,1,26,1,0,60,54,114
2023/4/21 17:20,1,26,1,0,81,57,138
2023/4/21 17:30,1,26,1,0,72,92,164
2023/4/21 17:40,1,26,1,0,90,272,362
2023/4/21 17:50,1,26,1,0,90,246,336
2023/4/21 18:00,1,25,1,0,105,233,338
2023/4/21 18:10,1,25,1,0,92,127,219
2023/4/21 18:20,1,23,1,0,92,104,196
2023/4/21 18:30,1,23,1,0,105,85,190
2023/4/21 18:40,1,22,1,0,192,78,270
2023/4/21 18:50,1,22,1,0,157,76,233
2023/4/21 19:00,1,22,1,0,122,61,183
2023/4/21 19:10,1,21,1,0,106,68,174
2023/4/21 19:20,1,21,1,0,102,62,164
2023/4/21 19:30,1,21,1,0,93,59,152
2023/4/21 19:40,1,21,1,0,92,58,150
2023/4/21 19:50,1,21,1,0,95,71,166
2023/4/21 20:00,1,21,1,0,73,75,148
2023/4/21 20:10,1,21,1,0,74,69,143
2023/4/21 20:20,1,21,1,0,84,65,149
2023/4/21 20:30,1,20,1,0,66,107,173
2023/4/21 20:40,1,20,1,0,59,208,267
2023/4/21 20:50,1,20,1,0,50,266,316
2023/4/21 21:00,1,19,1,0,42,182,224
2023/4/21 21:10,1,19,1,0,55,121,176
2023/4/21 21:20,1,18,1,0,34,114,148
2023/4/21 21:30,1,18,1,0,20,62,82
2023/4/21 21:40,1,18,1,0,18,68,86
2023/4/21 21:50,1,18,1,0,20,80,100
2023/4/21 22:00,1,17,1,0,14,75,89
2023/4/21 22:10,1,17,1,0,17,80,97
2023/4/21 22:20,1,17,1,0,16,47,63
2023/4/21 22:30,1,16,1,0,14,35,49
2023/4/21 22:40,1,16,1,0,9,18,27
2023/4/21 22:50,1,16,1,0,8,11,19
2023/4/21 23:00,1,16,1,0,11,10,21
2023/4/21 23:10,1,16,1,0,6,13,19
2023/4/21 23:20,1,15,1,0,5,10,15
2023/4/21 23:30,1,15,1,0,1,10,11
2023/4/21 23:40,1,15,1,0,1,11,12
2023/4/21 23:50,1,15,1,0,0,5,5
2023/4/22 0:00,1,15,0,0,2,1,3
2023/4/22 0:10,1,15,0,0,1,1,2
2023/4/22 0:20,1,14,0,0,0,0,0
2023/4/22 0:30,1,14,0,0,1,2,3
2023/4/22 0:40,1,13,0,0,0,2,2
2023/4/22 0:50,1,13,0,0,0,1,1
2023/4/22 1:00,1,13,0,0,0,1,1
2023/4/22 1:10,1,13,0,0,2,2,4
2023/4/22 1:20,1,12,0,0,1,1,2
2023/4/22 1:30,1,11,0,0,1,1,2
2023/4/22 1:40,1,11,0,0,0,2,2
2023/4/22 1:50,1,11,0,0,1,2,3
2023/4/22 2:00,1,10,0,0,1,2,3
2023/4/22 2:10,1,10,0,0,2,2,4
2023/4/22 2:20,1,10,0,0,2,0,2
2023/4/22 2:30,1,10,0,0,2,2,4
2023/4/22 2:40,1,10,0,0,1,1,2
2023/4/22 2:50,1,10,0,0,1,0,1
2023/4/22 3:00,1,9,0,0,2,1,3
2023/4/22 3:10,1,9,0,0,2,0,2
2023/4/22 3:20,1,9,0,0,2,0,2
2023/4/22 3:30,1,9,0,0,2,2,4
2023/4/22 3:40,1,9,0,0,2,0,2
2023/4/22 3:50,1,9,0,0,1,0,1
2023/4/22 4:00,1,9,0,0,1,0,1
2023/4/22 4:10,1,9,0,0,2,0,2
2023/4/22 4:20,1,9,0,0,1,2,3
2023/4/22 4:30,1,9,0,0,0,0,0
2023/4/22 4:40,1,9,0,0,2,2,4
2023/4/22 4:50,1,9,0,0,0,1,1
2023/4/22 5:00,1,9,0,0,1,0,1
2023/4/22 5:10,1,9,0,0,2,2,4
2023/4/22 5:20,1,9,0,0,1,1,2
2023/4/22 5:30,1,9,0,0,0,2,2
2023/4/22 5:40,1,9,0,0,1,0,1
2023/4/22 5:50,1,9,0,0,3,0,3
2023/4/22 6:00,1,10,0,0,4,0,4
2023/4/22 6:10,1,10,0,0,6,0,6
2023/4/22 6:20,1,10,0,0,8,0,8
2023/4/22 6:30,1,10,0,0,8,3,11
2023/4/22 6:40,1,10,0,0,9,2,11
2023/4/22 6:50,1,10,0,0,9,4,13
2023/4/22 7:00,1,10,0,0,13,0,13
2023/4/22 7:10,1,11,0,0,20,3,23
2023/4/22 7:20,1,11,0,0,38,2,40
2023/4/22 7:30,1,11,0,0,51,3,54
2023/4/22 7:40,1,11,0,0,58,2,60
2023/4/22 7:50,1,11,0,0,54,2,56
2023/4/22 8:00,1,11,0,0,41,5,46
2023/4/22 8:10,1,11,0,0,41,3,44
2023/4/22 8:20,1,11,0,0,29,1,30
2023/4/22 8:30,1,11,0,0,34,2,36
2023/4/22 8:40,1,11,0,0,30,4,34
2023/4/22 8:50,1,12,0,0,34,4,38
2023/4/22 9:00,1,12,0,0,30,4,34
2023/4/22 9:10,1,12,0,0,31,4,35
2023/4/22 9:20,1,12,0,0,37,7,44
2023/4/22 9:30,1,12,0,0,33,16,49
2023/4/22 9:40,1,12,0,0,41,14,55
2023/4/22 9:50,1,12,0,0,42,9,51
2023/4/22 10:00,1,12,0,0,35,16,51
2023/4/22 10:10,1,12,0,0,26,13,39
2023/4/22 10:20,1,12,0,0,21,8,29
2023/4/22 10:30,1,12,0,0,21,11,32
2023/4/22 10:40,1,12,0,0,18,13,31
2023/4/22 10:50,1,12,0,0,20,17,37
2023/4/22 11:00,1,12,0,0,15,17,32
2023/4/22 11:10,1,13,0,0,17,16,33
2023/4/22 11:20,1,13,0,0,10,19,29
2023/4/22 11:30,1,13,0,0,14,23,37
2023/4/22 11:40,1,13,0,0,9,26,35
2023/4/22 11:50,1,13,0,0,10,31,41
2023/4/22 12:00,1,13,0,0,13,37,50
2023/4/22 12:10,1,13,0,0,14,26,40
2023/4/22 12:20,1,13,0,0,10,28,38
2023/4/22 12:30,1,13,0,0,13,31,44
2023/4/22 12:40,1,13,0,0,11,30,41
2023/4/22 12:50,1,13,0,0,10,24,34
2023/4/22 13:00,1,13,0,0,10,23,33
2023/4/22 13:10,1,13,0,0,14,17,31
2023/4/22 13:20,1,13,0,0,14,16,30
2023/4/22 13:30,1,13,0,0,16,16,32
2023/4/22 13:40,1,13,0,0,26,20,46
2023/4/22 13:50,1,13,0,0,21,18,39
2023/4/22 14:00,1,13,0,0,24,16,40
2023/4/22 14:10,1,13,0,0,16,18,34
2023/4/22 14:20,1,13,0,0,15,16,31
2023/4/22 14:30,1,14,0,0,16,19,35
2023/4/22 14:40,1,14,0,0,15,15,30
2023/4/22 14:50,1,14,0,0,17,15,32
2023/4/22 15:00,1,14,0,0,19,11,30
2023/4/22 15:10,1,14,0,0,21,15,36
2023/4/22 15:20,1,14,0,0,22,14,36
2023/4/22 15:30,1,14,0,0,28,14,42
2023/4/22 15:40,1,14,0,0,25,18,43
2023/4/22 15:50,1,14,0,0,26,17,43
2023/4/22 16:00,1,14,0,0,23,15,38
2023/4/22 16:10,1,14,0,0,24,17,41
2023/4/22 16:20,1,14,0,0,22,11,33
2023/4/22 16:30,1,14,0,0,33,12,45
2023/4/22 16:40,1,14,0,0,32,9,41
2023/4/22 16:50,1,14,0,0,31,18,49
2023/4/22 17:00,1,14,0,0,36,16,52
2023/4/22 17:10,1,14,0,0,33,21,54
2023/4/22 17:20,1,14,0,0,41,24,65
2023/4/22 17:30,1,14,0,0,39,22,61
2023/4/22 17:40,1,14,0,0,31,35,66
2023/4/22 17:50,1,14,0,0,39,30,69
2023/4/22 18:00,1,14,0,0,45,33,78
2023/4/22 18:10,1,14,0,0,39,26,65
2023/4/22 18:20,1,14,0,0,46,23,69
2023/4/22 18:30,1,14,0,0,46,27,73
2023/4/22 18:40,1,14,0,0,39,28,67
2023/4/22 18:50,1,14,0,0,40,28,68
2023/4/22 19:00,1,14,0,0,36,24,60
2023/4/22 19:10,1,14,0,0,28,19,47
2023/4/22 19:20,1,13,0,0,25,17,42
2023/4/22 19:30,1,13,0,0,26,20,46
2023/4/22 19:40,1,13,0,0,25,21,46
2023/4/22 19:50,1,13,0,0,23,15,38
2023/4/22 20:00,1,13,0,0,25,22,47
2023/4/22 20:10,1,13,0,0,16,21,37
2023/4/22 20:20,1,13,0,0,16,20,36
2023/4/22 20:30,1,13,0,0,15,26,41
2023/4/22 20:40,1,13,0,0,18,28,46
2023/4/22 20:50,1,13,0,0,15,35,50
2023/4/22 21:00,1,13,0,0,10,33,43
2023/4/22 21:10,1,13,0,0,13,30,43
2023/4/22 21:20,1,13,0,0,11,24,35
2023/4/22 21:30,1,13,0,0,9,21,30
2023/4/22 21:40,1,12,0,0,7,36,43
2023/4/22 21:50,1,12,0,0,10,40,50
2023/4/22 22:00,1,12,0,0,5,39,44
2023/4/22 22:10,1,12,0,0,3,36,39
2023/4/22 22:20,1,12,0,0,4,26,30
2023/4/22 22:30,1,12,0,0,3,17,20
2023/4/22 22:40,1,12,0,0,3,12,15
2023/4/22 22:50,1,12,0,0,3,10,13
2023/4/22 23:00,1,12,0,0,2,7,9
2023/4/22 23:10,1,12,0,0,1,6,7
2023/4/22 23:20,1,11,0,0,1,1,2
2023/4/22 23:30,1,11,0,0,0,2,2
2023/4/22 23:40,1,11,0,0,2,1,3
2023/4/22 23:50,1,11,0,0,1,2,3
2023/4/23 0:00,1,11,1,0,4,0,4
2023/4/23 0:10,1,11,1,0,3,1,4
2023/4/23 0:20,1,10,1,0,4,3,7
2023/4/23 0:30,1,10,1,0,2,0,2
2023/4/23 0:40,1,10,1,0,2,1,3
2023/4/23 0:50,1,10,1,0,1,1,2
2023/4/23 1:00,1,10,1,0,0,1,1
2023/4/23 1:10,1,10,1,0,0,1,1
2023/4/23 1:20,1,10,1,0,0,0,0
2023/4/23 1:30,1,10,1,0,2,0,2
2023/4/23 1:40,1,10,1,0,1,2,3
2023/4/23 1:50,1,10,1,0,0,1,1
2023/4/23 2:00,1,10,1,0,0,0,0
2023/4/23 2:10,1,9,1,0,1,2,3
2023/4/23 2:20,1,9,1,0,1,2,3
2023/4/23 2:30,1,9,1,0,2,1,3
2023/4/23 2:40,1,9,1,0,0,1,1
2023/4/23 2:50,1,9,1,0,0,0,0
2023/4/23 3:00,1,9,1,0,2,1,3
2023/4/23 3:10,1,9,1,0,1,1,2
2023/4/23 3:20,1,9,1,0,2,1,3
2023/4/23 3:30,1,9,1,0,1,2,3
2023/4/23 3:40,1,9,1,0,0,2,2
2023/4/23 3:50,1,9,1,0,1,2,3
2023/4/23 4:00,1,9,1,0,2,0,2
2023/4/23 4:10,1,9,1,0,2,1,3
2023/4/23 4:20,1,9,1,0,1,0,1
2023/4/23 4:30,1,9,1,0,1,0,1
2023/4/23 4:40,1,9,1,0,1,1,2
2023/4/23 4:50,1,9,1,0,0,0,0
2023/4/23 5:00,1,9,1,0,1,2,3
2023/4/23 5:10,1,9,1,0,0,2,2
2023/4/23 5:20,1,9,1,0,0,0,0
2023/4/23 5:30,1,9,1,0,1,2,3
2023/4/23 5:40,1,9,1,0,2,0,2
2023/4/23 5:50,1,9,1,0,5,2,7
2023/4/23 6:00,1,9,1,0,3,2,5
2023/4/23 6:10,1,9,1,0,4,1,5
2023/4/23 6:20,1,9,1,0,5,1,6
2023/4/23 6:30,1,9,1,0,6,4,10
2023/4/23 6:40,1,9,1,0,13,2,15
2023/4/23 6:50,1,9,1,0,34,1,35
2023/4/23 7:00,1,10,1,0,67,4,71
2023/4/23 7:10,1,10,1,0,82,0,82
2023/4/23 7:20,1,10,1,0,113,3,116
2023/4/23 7:30,1,10,1,0,302,1,303
2023/4/23 7:40,1,10,1,0,501,3,504
2023/4/23 7:50,1,10,1,0,624,6,630
2023/4/23 8:00,1,10,1,0,257,8,265
2023/4/23 8:10,1,10,1,0,135,12,147
2023/4/23 8:20,1,10,1,0,94,10,104
2023/4/23 8:30,1,10,1,0,80,12,92
2023/4/23 8:40,1,10,1,0,75,13,88
2023/4/23 8:50,1,10,1,0,84,14,98
2023/4/23 9:00,1,10,1,0,82,17,99
2023/4/23 9:10,1,10,1,0,86,18,104
2023/4/23 9:20,1,10,1,0,161,32,193
2023/4/23 9:30,1,10,1,0,202,37,239
2023/4/23 9:40,1,10,1,0,255,139,394
2023/4/23 9:50,1,10,1,0,174,161,335
2023/4/23 10:00,1,10,1,0,142,138,280
2023/4/23 10:10,1,10,1,0,82,88,170
2023/4/23 10:20,1,10,1,0,79,62,141
2023/4/23 10:30,1,10,1,0,68,47,115
2023/4/23 10:40,1,10,1,0,57,51,108
2023/4/23 10:50,1,10,1,0,66,40,106
2023/4/23 11:00,1,10,1,0,64,41,105
2023/4/23 11:10,1,10,1,0,66,35,101
2023/4/23 11:20,1,11,1,0,58,40,98
2023/4/23 11:30,1,11,1,0,78,80,158
2023/4/23 11:40,1,11,1,0,76,220,296
2023/4/23 11:50,1,11,1,0,76,299,375
2023/4/23 12:00,1,11,1,0,56,263,319
2023/4/23 12:10,1,11,1,0,51,199,250
2023/4/23 12:20,1,11,1,0,58,116,174
2023/4/23 12:30,1,11,1,0,57,79,136
2023/4/23 12:40,1,11,1,0,66,57,123
2023/4/23 12:50,1,11,1,0,61,57,118
2023/4/23 13:00,1,11,1,0,68,29,97
2023/4/23 13:10,1,11,1,0,61,37,98
2023/4/23 13:20,1,11,1,0,90,36,126
2023/4/23 13:30,1,11,1,0,153,35,188
2023/4/23 13:40,1,11,1,0,227,31,258
2023/4/23 13:50,1,11,1,0,212,38,250
2023/4/23 14:00,1,11,1,0,127,30,157
2023/4/23 14:10,1,11,1,0,101,39,140
2023/4/23 14:20,1,11,1,0,105,34,139
2023/4/23 14:30,1,11,1,0,79,41,120
2023/4/23 14:40,1,11,1,0,75,42,117
2023/4/23 14:50,1,11,1,0,74,43,117
2023/4/23 15:00,1,11,1,0,77,41,118
2023/4/23 15:10,1,11,1,0,80,43,123
2023/4/23 15:20,1,11,1,0,78,43,121
2023/4/23 15:30,1,12,1,0,94,58,152
2023/4/23 15:40,1,12,1,0,124,161,285
2023/4/23 15:50,1,12,1,0,171,231,402
2023/4/23 16:00,1,12,1,0,97,146,243
2023/4/23 16:10,1,12,1,0,87,129,216
2023/4/23 16:20,1,12,1,0,79,76,155
2023/4/23 16:30,1,12,1,0,83,71,154
2023/4/23 16:40,1,12,1,0,66,56,122
2023/4/23 16:50,1,12,1,0,76,59,135
2023/4/23 17:00,1,12,1,0,75,58,133
2023/4/23 17:10,1,12,1,0,77,56,133
2023/4/23 17:20,1,12,1,0,86,56,142
2023/4/23 17:30,1,12,1,0,79,93,172
2023/4/23 17:40,1,12,1,0,91,266,357
2023/4/23 17:50,1,12,1,0,98,278,376
2023/4/23 18:00,1,12,1,0,98,229,327
2023/4/23 18:10,1,12,1,0,84,146,230
2023/4/23 18:20,1,12,1,0,104,94,198
2023/4/23 18:30,1,12,1,0,107,76,183
2023/4/23 18:40,1,12,1,0,186,79,265
2023/4/23 18:50,1,12,1,0,188,68,256
2023/4/23 19:00,1,12,1,0,116,64,180
2023/4/23 19:10,1,12,1,0,120,59,179
2023/4/23 19:20,1,12,1,0,111,69,180
2023/4/23 19:30,1,12,1,0,95,56,151
2023/4/23 19:40,1,12,1,0,85,66,151
2023/4/23 19:50,1,12,1,0,84,63,147
2023/4/23 20:00,1,12,1,0,76,69,145
2023/4/23 20:10,1,12,1,0,85,61,146
2023/4/23 20:20,1,12,1,0,70,61,131
2023/4/23 20:30,1,12,1,0,58,103,161
2023/4/23 20:40,1,12,1,0,72,176,248
2023/4/23 20:50,1,12,1,0,58,248,306
2023/4/23 21:00,1,12,1,0,55,177,232
2023/4/23 21:10,1,12,1,0,57,145,202
2023/4/23 21:20,1,12,1,0,35,122,157
2023/4/23 21:30,1,12,1,0,22,65,87
2023/4/23 21:40,1,12,1,0,17,65,82
2023/4/23 21:50,1,12,1,0,16,89,105
2023/4/23 22:00,1,12,1,0,16,81,97
2023/4/23 22:10,1,11,1,0,17,74,91
2023/4/23 22:20,1,11,1,0,14,54,68
2023/4/23 22:30,1,11,1,0,14,35,49
2023/4/23 22:40,1,11,1,0,13,21,34
2023/4/23 22:50,1,11,1,0,8,11,19
2023/4/23 23:00,1,11,1,0,11,14,25
2023/4/23 23:10,1,11,1,0,7,12,19
2023/4/23 23:20,1,11,1,0,7,10,17
2023/4/23 23:30,1,11,1,0,2,9,11
2023/4/23 23:40,1,11,1,0,1,10,11
2023/4/23 23:50,1,11,1,0,0,3,3
2023/4/24 0:00,1,11,1,0,5,0,5
2023/4/24 0:10,1,11,1,0,4,0,4
2023/4/24 0:20,1,10,1,0,4,1,5
2023/4/24 0:30,1,10,1,0,2,1,3
2023/4/24 0:40,1,10,1,0,1,1,2
2023/4/24 0:50,1,10,1,0,0,0,0
2023/4/24 1:00,1,10,1,0,0,0,0
2023/4/24 1:10,1,10,1,0,0,2,2
2023/4/24 1:20,1,10,1,0,1,0,1
2023/4/24 1:30,1,10,1,0,1,1,2
2023/4/24 1:40,1,10,1,0,2,2,4
2023/4/24 1:50,1,10,1,0,2,0,2
2023/4/24 2:00,1,10,1,0,2,0,2
2023/4/24 2:10,1,10,1,0,0,0,0
2023/4/24 2:20,1,10,1,0,2,2,4
2023/4/24 2:30,1,10,1,0,0,2,2
2023/4/24 2:40,1,10,1,0,2,2,4
2023/4/24 2:50,1,10,1,0,2,1,3
2023/4/24 3:00,1,10,1,0,1,2,3
2023/4/24 3:10,1,10,1,0,2,2,4
2023/4/24 3:20,1,10,1,0,2,0,2
2023/4/24 3:30,1,10,1,0,2,0,2
2023/4/24 3:40,1,10,1,0,1,0,1
2023/4/24 3:50,1,10,1,0,2,1,3
2023/4/24 4:00,1,10,1,0,2,1,3
2023/4/24 4:10,1,10,1,0,1,2,3
2023/4/24 4:20,1,10,1,0,2,0,2
2023/4/24 4:30,1,10,1,0,0,0,0
2023/4/24 4:40,1,10,1,0,1,2,3
2023/4/24 4:50,1,10,1,0,0,0,0
2023/4/24 5:00,1,10,1,0,2,0,2
2023/4/24 5:10,1,10,1,0,2,0,2
2023/4/24 5:20,1,10,1,0,1,2,3
2023/4/24 5:30,1,10,1,0,3,0,3
2023/4/24 5:40,1,10,1,0,2,1,3
2023/4/24 5:50,1,10,1,0,3,0,3
2023/4/24 6:00,1,10,1,0,4,2,6
2023/4/24 6:10,1,10,1,0,3,3,6
2023/4/24 6:20,1,10,1,0,5,3,8
2023/4/24 6:30,1,10,1,0,5,3,8
2023/4/24 6:40,1,10,1,0,10,2,12
2023/4/24 6:50,1,10,1,0,38,2,40
2023/4/24 7:00,1,10,1,0,56,4,60
2023/4/24 7:10,1,10,1,0,103,2,105
2023/4/24 7:20,1,10,1,0,105,3,108
2023/4/24 7:30,1,11,1,0,344,1,345
2023/4/24 7:40,1,11,1,0,603,5,608
2023/4/24 7:50,1,11,1,0,671,3,674
2023/4/24 8:00,1,11,1,0,293,6,299
2023/4/24 8:10,1,11,1,0,123,10,133
2023/4/24 8:20,1,11,1,0,105,8,113
2023/4/24 8:30,1,11,1,0,84,14,98
2023/4/24 8:40,1,11,1,0,76,16,92
2023/4/24 8:50,1,11,1,0,81,13,94
2023/4/24 9:00,1,11,1,0,71,16,87
2023/4/24 9:10,1,11,1,0,89,17,106
2023/4/24 9:20,1,11,1,0,147,31,178
2023/4/24 9:30,1,11,1,0,197,39,236
2023/4/24 9:40,1,11,1,0,251,125,376
2023/4/24 9:50,1,11,1,0,188,158,346
2023/4/24 10:00,1,11,1,0,152,137,289
2023/4/24 10:10,1,11,1,0,74,112,186
2023/4/24 10:20,1,11,1,0,72,78,150
2023/4/24 10:30,1,11,1,0,66,47,113
2023/4/24 10:40,1,11,1,0,64,40,104
2023/4/24 10:50,1,11,1,0,71,39,110
2023/4/24 11:00,1,11,1,0,59,38,97
2023/4/24 11:10,1,11,1,0,60,36,96
2023/4/24 11:20,1,11,1,0,64,49,113
2023/4/24 11:30,1,11,1,0,71,67,138
2023/4/24 11:40,1,11,1,0,68,232,300
2023/4/24 11:50,1,12,1,0,62,297,359
2023/4/24 12:00,1,12,1,0,59,235,294
2023/4/24 12:10,1,12,1,0,54,174,228
2023/4/24 12:20,1,12,1,0,67,105,172
2023/4/24 12:30,1,12,1,0,59,96,155
2023/4/24 12:40,1,12,1,0,63,70,133
2023/4/24 12:50,1,12,1,0,55,50,105
2023/4/24 13:00,1,12,1,0,56,31,87
2023/4/24 13:10,1,12,1,0,54,35,89
2023/4/24 13:20,1,12,1,0,81,28,109
2023/4/24 13:30,1,12,1,0,166,32,198
2023/4/24 13:40,1,12,1,0,263,33,296
2023/4/24 13:50,1,12,1,0,220,40,260
2023/4/24 14:00,1,12,1,0,139,35,174
2023/4/24 14:10,1,12,1,0,103,42,145
2023/4/24 14:20,1,12,1,0,98,44,142
2023/4/24 14:30,1,12,1,0,93,43,136
2023/4/24 14:40,1,12,1,0,74,42,116
2023/4/24 14:50,1,12,1,0,68,45,113
2023/4/24 15:00,1,12,1,0,63,47,110
2023/4/24 15:10,1,12,1,0,77,39,116
2023/4/24 15:20,1,12,1,0,85,40,125
2023/4/24 15:30,1,12,1,0,85,66,151
2023/4/24 15:40,1,12,1,0,148,172,320
2023/4/24 15:50,1,12,1,0,166,210,376
2023/4/24 16:00,1,12,1,0,118,165,283
2023/4/24 16:10,1,12,1,0,94,113,207
2023/4/24 16:20,1,12,1,0,79,84,163
2023/4/24 16:30,1,12,1,0,77,77,154
2023/4/24 16:40,1,12,1,0,78,54,132
2023/4/24 16:50,1,12,1,0,69,65,134
2023/4/24 17:00,1,12,1,0,83,59,142
2023/4/24 17:10,1,12,1,0,65,64,129
2023/4/24 17:20,1,12,1,0,70,53,123
2023/4/24 17:30,1,12,1,0,78,92,170
2023/4/24 17:40,1,12,1,0,77,271,348
2023/4/24 17:50,1,12,1,0,91,218,309
2023/4/24 18:00,1,12,1,0,93,184,277
2023/4/24 18:10,1,12,1,0,84,144,228
2023/4/24 18:20,1,12,1,0,100,91,191
2023/4/24 18:30,1,11,1,0,111,95,206
2023/4/24 18:40,1,11,1,0,199,78,277
2023/4/24 18:50,1,11,1,0,159,67,226
2023/4/24 19:00,1,11,1,0,145,59,204
2023/4/24 19:10,1,11,1,0,111,55,166
2023/4/24 19:20,1,11,1,0,86,58,144
2023/4/24 19:30,1,11,1,0,102,66,168
2023/4/24 19:40,1,11,1,0,84,53,137
2023/4/24 19:50,1,11,1,0,87,70,157
2023/4/24 20:00,1,11,1,0,72,72,144
2023/4/24 20:10,1,11,1,0,73,70,143
2023/4/24 20:20,1,11,1,0,72,63,135
2023/4/24 20:30,1,11,1,0,57,84,141
2023/4/24 20:40,1,11,1,0,73,208,281
2023/4/24 20:50,1,11,1,0,60,237,297
2023/4/24 21:00,1,10,1,0,53,149,202
2023/4/24 21:10,1,10,1,0,47,135,182
2023/4/24 21:20,1,10,1,0,30,109,139
2023/4/24 21:30,1,10,1,0,26,71,97
2023/4/24 21:40,1,10,1,0,17,83,100
2023/4/24 21:50,1,10,1,0,15,87,102
2023/4/24 22:00,1,10,1,0,14,82,96
2023/4/24 22:10,1,10,1,0,15,81,96
2023/4/24 22:20,1,10,1,0,16,49,65
2023/4/24 22:30,1,10,1,0,15,31,46
2023/4/24 22:40,1,10,1,0,11,21,32
2023/4/24 22:50,1,10,1,0,11,14,25
2023/4/24 23:00,1,10,1,0,10,12,22
2023/4/24 23:10,1,10,1,0,6,13,19
2023/4/24 23:20,1,10,1,0,6,10,16
2023/4/24 23:30,1,10,1,0,3,9,12
2023/4/24 23:40,1,10,1,0,2,10,12
2023/4/24 23:50,1,10,1,0,0,4,4
2023/4/25 0:00,1,10,1,0,3,2,5
2023/4/25 0:10,1,10,1,0,3,2,5
2023/4/25 0:20,1,9,1,0,3,3,6
2023/4/25 0:30,1,9,1,0,2,1,3
2023/4/25 0:40,1,9,1,0,2,0,2
2023/4/25 0:50,1,9,1,0,0,2,2
2023/4/25 1:00,1,9,1,0,1,2,3
2023/4/25 1:10,1,9,1,0,0,0,0
2023/4/25 1:20,1,9,1,0,0,0,0
2023/4/25 1:30,1,9,1,0,0,1,1
2023/4/25 1:40,1,9,1,0,2,0,2
2023/4/25 1:50,1,9,1,0,1,1,2
2023/4/25 2:00,1,9,1,0,1,0,1
2023/4/25 2:10,1,9,1,0,1,2,3
2023/4/25 2:20,1,9,1,0,2,1,3
2023/4/25 2:30,1,9,1,0,0,1,1
2023/4/25 2:40,1,9,1,0,0,2,2
2023/4/25 2:50,1,9,1,0,2,1,3
2023/4/25 3:00,1,9,1,0,1,0,1
2023/4/25 3:10,1,9,1,0,0,1,1
2023/4/25 3:20,1,9,1,0,0,1,1
2023/4/25 3:30,1,9,1,0,1,2,3
2023/4/25 3:40,1,9,1,0,1,2,3
2023/4/25 3:50,1,9,1,0,1,0,1
2023/4/25 4:00,1,9,1,0,1,2,3
2023/4/25 4:10,1,9,1,0,1,0,1
2023/4/25 4:20,1,9,1,0,2,1,3
2023/4/25 4:30,1,9,1,0,2,2,4
2023/4/25 4:40,1,9,1,0,1,1,2
2023/4/25 4:50,1,9,1,0,2,2,4
2023/4/25 5:00,1,9,1,0,0,2,2
2023/4/25 5:10,1,9,1,0,1,2,3
2023/4/25 5:20,1,9,1,0,2,1,3
2023/4/25 5:30,1,10,1,0,2,1,3
2023/4/25 5:40,1,10,1,0,1,1,2
2023/4/25 5:50,1,11,1,0,5,2,7
2023/4/25 6:00,1,11,1,0,2,3,5
2023/4/25 6:10,1,11,1,0,4,1,5
2023/4/25 6:20,1,11,1,0,7,1,8
2023/4/25 6:30,1,11,1,0,5,3,8
2023/4/25 6:40,1,11,1,0,13,0,13
2023/4/25 6:50,1,11,1,0,36,0,36
2023/4/25 7:00,1,12,1,0,57,3,60
2023/4/25 7:10,1,12,1,0,95,2,97
2023/4/25 7:20,1,12,1,0,102,3,105
2023/4/25 7:30,1,12,1,0,295,1,296
2023/4/25 7:40,1,12,1,0,614,5,619
2023/4/25 7:50,1,13,1,0,607,3,610
2023/4/25 8:00,1,13,1,0,277,6,283
2023/4/25 8:10,1,13,1,0,127,12,139
2023/4/25 8:20,1,13,1,0,100,10,110
2023/4/25 8:30,1,13,1,0,87,13,100
2023/4/25 8:40,1,14,1,0,86,12,98
2023/4/25 8:50,1,14,1,0,70,14,84
2023/4/25 9:00,1,14,1,0,85,14,99
2023/4/25 9:10,1,14,1,0,92,18,110
2023/4/25 9:20,1,14,1,0,156,29,185
2023/4/25 9:30,1,14,1,0,225,43,268
2023/4/25 9:40,1,14,1,0,265,116,381
2023/4/25 9:50,1,15,1,0,206,176,382
2023/4/25 10:00,1,15,1,0,120,167,287
2023/4/25 10:10,1,15,1,0,77,107,184
2023/4/25 10:20,1,15,1,0,72,63,135
2023/4/25 10:30,1,15,1,0,57,53,110
2023/4/25 10:40,1,15,1,0,60,48,108
2023/4/25 10:50,1,15,1,0,60,45,105
2023/4/25 11:00,1,16,1,0,65,43,108
2023/4/25 11:10,1,16,1,0,62,43,105
2023/4/25 11:20,1,16,1,0,59,42,101
2023/4/25 11:30,1,16,1,0,72,78,150
2023/4/25 11:40,1,16,1,0,73,198,271
2023/4/25 11:50,1,16,1,0,66,294,360
2023/4/25 12:00,1,17,1,0,59,239,298
2023/4/25 12:10,1,17,1,0,52,191,243
2023/4/25 12:20,1,17,1,0,54,114,168
2023/4/25 12:30,1,17,1,0,62,91,153
2023/4/25 12:40,1,17,1,0,53,72,125
2023/4/25 12:50,1,17,1,0,58,57,115
2023/4/25 13:00,1,17,1,0,65,26,91
2023/4/25 13:10,1,17,1,0,69,36,105
2023/4/25 13:20,1,17,1,0,83,29,112
2023/4/25 13:30,1,18,1,0,185,39,224
2023/4/25 13:40,1,18,1,0,268,39,307
2023/4/25 13:50,1,18,1,0,215,36,251
2023/4/25 14:00,1,18,1,0,118,30,148
2023/4/25 14:10,1,18,1,0,121,41,162
2023/4/25 14:20,1,18,1,0,111,39,150
2023/4/25 14:30,1,19,1,0,83,45,128
2023/4/25 14:40,1,19,1,0,80,41,121
2023/4/25 14:50,1,19,1,0,71,42,113
2023/4/25 15:00,1,19,1,0,76,45,121
2023/4/25 15:10,1,19,1,0,74,38,112
2023/4/25 15:20,1,19,1,0,82,43,125
2023/4/25 15:30,1,19,1,0,96,65,161
2023/4/25 15:40,1,19,1,0,144,193,337
2023/4/25 15:50,1,19,1,0,147,232,379
2023/4/25 16:00,1,19,1,0,116,134,250
2023/4/25 16:10,1,19,1,0,95,115,210
2023/4/25 16:20,1,19,1,0,71,84,155
2023/4/25 16:30,1,19,1,0,79,64,143
2023/4/25 16:40,1,19,1,0,74,60,134
2023/4/25 16:50,1,19,1,0,71,67,138
2023/4/25 17:00,1,19,1,0,79,52,131
2023/4/25 17:10,1,19,1,0,69,52,121
2023/4/25 17:20,1,19,1,0,71,60,131
2023/4/25 17:30,1,19,1,0,91,80,171
2023/4/25 17:40,1,19,1,0,89,270,359
2023/4/25 17:50,1,18,1,0,97,239,336
2023/4/25 18:00,1,18,1,0,103,216,319
2023/4/25 18:10,1,18,1,0,95,123,218
2023/4/25 18:20,1,18,1,0,88,105,193
2023/4/25 18:30,1,18,1,0,122,94,216
2023/4/25 18:40,1,18,1,0,176,71,247
2023/4/25 18:50,1,18,1,0,156,60,216
2023/4/25 19:00,1,17,1,0,119,55,174
2023/4/25 19:10,1,17,1,0,121,62,183
2023/4/25 19:20,1,17,1,0,107,65,172
2023/4/25 19:30,1,17,1,0,88,60,148
2023/4/25 19:40,1,17,1,0,79,63,142
2023/4/25 19:50,1,17,1,0,94,62,156
2023/4/25 20:00,1,17,1,0,77,69,146
2023/4/25 20:10,1,16,1,0,85,62,147
2023/4/25 20:20,1,16,1,0,75,62,137
2023/4/25 20:30,1,16,1,0,64,105,169
2023/4/25 20:40,1,16,1,0,65,177,242
2023/4/25 20:50,1,16,1,0,49,253,302
2023/4/25 21:00,1,16,1,0,48,178,226
2023/4/25 21:10,1,16,1,0,47,127,174
2023/4/25 21:20,1,15,1,0,29,120,149
2023/4/25 21:30,1,15,1,0,25,74,99
2023/4/25 21:40,1,15,1,0,17,82,99
2023/4/25 21:50,1,15,1,0,15,88,103
2023/4/25 22:00,1,15,1,0,15,88,103
2023/4/25 22:10,1,15,1,0,16,68,84
2023/4/25 22:20,1,15,1,0,16,51,67
2023/4/25 22:30,1,15,1,0,12,37,49
2023/4/25 22:40,1,14,1,0,11,22,33
2023/4/25 22:50,1,14,1,0,8,12,20
2023/4/25 23:00,1,14,1,0,11,13,24
2023/4/25 23:10,1,14,1,0,5,14,19
2023/4/25 23:20,1,14,1,0,6,12,18
2023/4/25 23:30,1,14,1,0,1,9,10
2023/4/25 23:40,1,14,1,0,2,9,11
2023/4/25 23:50,1,14,1,0,1,3,4
2023/4/26 0:00,1,13,1,0,5,0,5
2023/4/26 0:10,1,13,1,0,3,1,4
2023/4/26 0:20,1,13,1,0,2,1,3
2023/4/26 0:30,1,13,1,0,1,1,2
2023/4/26 0:40,1,13,1,0,1,0,1
2023/4/26 0:50,1,13,1,0,1,1,2
2023/4/26 1:00,1,13,1,0,2,1,3
2023/4/26 1:10,1,12,1,0,0,2,2
2023/4/26 1:20,1,12,1,0,0,1,1
2023/4/26 1:30,1,12,1,0,0,0,0
2023/4/26 1:40,1,12,1,0,2,2,4
2023/4/26 1:50,1,12,1,0,0,0,0
2023/4/26 2:00,1,12,1,0,1,1,2
2023/4/26 2:10,1,12,1,0,1,1,2
2023/4/26 2:20,1,12,1,0,1,0,1
2023/4/26 2:30,1,12,1,0,2,1,3
2023/4/26 2:40,1,12,1,0,1,0,1
2023/4/26 2:50,1,11,1,0,2,0,2
2023/4/26 3:00,1,11,1,0,1,2,3
2023/4/26 3:10,1,11,1,0,1,1,2
2023/4/26 3:20,1,11,1,0,1,2,3
2023/4/26 3:30,1,11,1,0,2,0,2
2023/4/26 3:40,1,11,1,0,2,0,2
2023/4/26 3:50,1,11,1,0,0,2,2
2023/4/26 4:00,1,11,1,0,1,0,1
2023/4/26 4:10,1,11,1,0,1,2,3
2023/4/26 4:20,1,11,1,0,1,1,2
2023/4/26 4:30,1,11,1,0,2,1,3
2023/4/26 4:40,1,11,1,0,2,1,3
2023/4/26 4:50,1,11,1,0,2,0,2
2023/4/26 5:00,1,11,1,0,1,1,2
2023/4/26 5:10,1,12,1,0,1,0,1
2023/4/26 5:20,1,12,1,0,2,2,4
2023/4/26 5:30,1,12,1,0,3,1,4
2023/4/26 5:40,1,12,1,0,0,1,1
2023/4/26 5:50,1,12,1,0,4,0,4
2023/4/26 6:00,1,12,1,0,3,2,5
2023/4/26 6:10,1,12,1,0,3,2,5
2023/4/26 6:20,1,12,1,0,4,3,7
2023/4/26 6:30,1,12,1,0,6,3,9
2023/4/26 6:40,1,13,1,0,11,1,12
2023/4/26 6:50,1,13,1,0,42,2,44
2023/4/26 7:00,1,13,1,0,59,3,62
2023/4/26 7:10,1,13,1,0,84,0,84
2023/4/26 7:20,1,14,1,0,119,3,122
2023/4/26 7:30,1,14,1,0,335,0,335
2023/4/26 7:40,1,14,1,0,606,3,609
2023/4/26 7:50,1,14,1,0,599,4,603
2023/4/26 8:00,1,14,1,0,309,5,314
2023/4/26 8:10,1,14,1,0,141,8,149
2023/4/26 8:20,1,15,1,0,84,10,94
2023/4/26 8:30,1,15,1,0,72,11,83
2023/4/26 8:40,1,15,1,0,81,15,96
2023/4/26 8:50,1,15,1,0,66,13,79
2023/4/26 9:00,1,15,1,0,80,13,93
2023/4/26 9:10,1,15,1,0,84,17,101
2023/4/26 9:20,1,16,1,0,137,30,167
2023/4/26 9:30,1,16,1,0,229,44,273
2023/4/26 9:40,1,16,1,0,254,127,381
2023/4/26 9:50,1,16,1,0,210,183,393
2023/4/26 10:00,1,16,1,0,129,139,268
2023/4/26 10:10,1,17,1,0,88,88,176
2023/4/26 10:20,1,17,1,0,85,68,153
2023/4/26 10:30,1,17,1,0,57,52,109
2023/4/26 10:40,1,17,1,0,65,40,105
2023/4/26 10:50,1,17,1,0,64,40,104
2023/4/26 11:00,1,17,1,0,60,43,103
2023/4/26 11:10,1,18,1,0,54,37,91
2023/4/26 11:20,1,18,1,0,67,40,107
2023/4/26 11:30,1,19,1,0,73,73,146
2023/4/26 11:40,1,19,1,0,75,245,320
2023/4/26 11:50,1,19,1,0,63,276,339
2023/4/26 12:00,1,19,1,0,65,253,318
2023/4/26 12:10,1,19,1,0,49,199,248
2023/4/26 12:20,1,19,1,0,62,130,192
2023/4/26 12:30,1,20,1,0,45,92,137
2023/4/26 12:40,1,20,1,0,25,64,89
2023/4/26 12:50,1,20,1,0,18,54,72
2023/4/26 13:00,1,20,1,0,19,28,47
2023/4/26 13:10,1,20,1,0,14,17,31
2023/4/26 13:20,1,21,1,0,17,16,33
2023/4/26 13:30,1,21,1,0,18,17,35
2023/4/26 13:40,1,21,1,0,31,21,52
2023/4/26 13:50,1,21,1,0,26,23,49
2023/4/26 14:00,1,21,1,0,28,24,52
2023/4/26 14:10,1,21,1,0,20,23,43
2023/4/26 14:20,1,22,1,0,20,15,35
2023/4/26 14:30,1,22,1,0,16,17,33
2023/4/26 14:40,1,22,1,0,19,18,37
2023/4/26 14:50,1,23,1,0,23,14,37
2023/4/26 15:00,1,23,1,0,23,11,34
2023/4/26 15:10,1,23,1,0,30,18,48
2023/4/26 15:20,1,23,1,0,24,14,38
2023/4/26 15:30,1,23,1,0,34,21,55
2023/4/26 15:40,1,23,1,0,29,21,50
2023/4/26 15:50,1,24,1,0,32,20,52
2023/4/26 16:00,1,24,1,0,29,18,47
2023/4/26 16:10,1,24,1,0,33,19,52
2023/4/26 16:20,1,24,1,0,31,16,47
2023/4/26 16:30,1,24,1,0,40,14,54
2023/4/26 16:40,1,24,1,0,30,15,45
2023/4/26 16:50,1,24,1,0,39,18,57
2023/4/26 17:00,1,24,1,0,39,21,60
2023/4/26 17:10,1,25,1,0,40,21,61
2023/4/26 17:20,1,25,1,0,43,23,66
2023/4/26 17:30,1,25,1,0,46,33,79
2023/4/26 17:40,1,25,1,0,44,35,79
2023/4/26 17:50,1,25,1,0,49,42,91
2023/4/26 18:00,1,25,1,0,50,35,85
2023/4/26 18:10,1,25,1,0,56,37,93
2023/4/26 18:20,1,25,1,0,48,34,82
2023/4/26 18:30,1,25,1,0,48,37,85
2023/4/26 18:40,1,25,1,0,50,34,84
2023/4/26 18:50,1,25,1,0,44,32,76
2023/4/26 19:00,1,25,1,0,37,25,62
2023/4/26 19:10,1,25,1,0,32,27,59
2023/4/26 19:20,1,25,1,0,27,23,50
2023/4/26 19:30,1,25,1,0,26,20,46
2023/4/26 19:40,1,25,1,0,31,26,57
2023/4/26 19:50,1,25,1,0,29,19,48
2023/4/26 20:00,1,24,1,0,29,27,56
2023/4/26 20:10,1,24,1,0,22,22,44
2023/4/26 20:20,1,24,1,0,20,31,51
2023/4/26 20:30,1,24,1,0,22,37,59
2023/4/26 20:40,1,24,1,0,20,33,53
2023/4/26 20:50,1,24,1,0,19,34,53
2023/4/26 21:00,1,23,1,0,15,43,58
2023/4/26 21:10,1,23,1,0,16,30,46
2023/4/26 21:20,1,23,1,0,15,30,45
2023/4/26 21:30,1,23,1,0,12,30,42
2023/4/26 21:40,1,23,1,0,9,48,57
2023/4/26 21:50,1,23,1,0,11,44,55
2023/4/26 22:00,1,23,1,0,5,48,53
2023/4/26 22:10,1,23,1,0,5,44,49
2023/4/26 22:20,1,23,1,0,3,35,38
2023/4/26 22:30,1,23,1,0,3,22,25
2023/4/26 22:40,1,22,1,0,1,13,14
2023/4/26 22:50,1,22,1,0,4,12,16
2023/4/26 23:00,1,22,1,0,1,6,7
2023/4/26 23:10,1,22,1,0,1,4,5
2023/4/26 23:20,1,22,1,0,0,2,2
2023/4/26 23:30,1,22,1,0,2,1,3
2023/4/26 23:40,1,22,1,0,0,2,2
2023/4/26 23:50,1,22,1,0,2,2,4
2023/4/27 0:00,1,22,1,0,4,2,6
2023/4/27 0:10,1,21,1,0,4,1,5
2023/4/27 0:20,1,21,1,0,4,1,5
2023/4/27 0:30,1,21,1,0,2,2,4
2023/4/27 0:40,1,21,1,0,3,2,5
2023/4/27 0:50,1,21,1,0,2,2,4
2023/4/27 1:00,1,21,1,0,0,0,0
2023/4/27 1:10,1,20,1,0,2,1,3
2023/4/27 1:20,1,20,1,0,1,0,1
2023/4/27 1:30,1,20,1,0,1,1,2
2023/4/27 1:40,1,20,1,0,2,0,2
2023/4/27 1:50,1,20,1,0,2,1,3
2023/4/27 2:00,1,20,1,0,1,2,3
2023/4/27 2:10,1,20,1,0,1,1,2
2023/4/27 2:20,1,20,1,0,2,2,4
2023/4/27 2:30,1,20,1,0,0,0,0
2023/4/27 2:40,1,19,1,0,1,0,1
2023/4/27 2:50,1,19,1,0,0,1,1
2023/4/27 3:00,1,19,1,0,0,2,2
2023/4/27 3:10,1,19,1,0,1,1,2
2023/4/27 3:20,1,18,1,0,2,1,3
2023/4/27 3:30,1,18,1,0,2,0,2
2023/4/27 3:40,1,18,1,0,0,2,2
2023/4/27 3:50,1,18,1,0,2,2,4
2023/4/27 4:00,1,18,1,0,0,0,0
2023/4/27 4:10,1,18,1,0,1,0,1
2023/4/27 4:20,1,18,1,0,0,0,0
2023/4/27 4:30,1,18,1,0,1,0,1
2023/4/27 4:40,1,18,1,0,2,1,3
2023/4/27 4:50,1,18,1,0,1,1,2
2023/4/27 5:00,1,18,1,0,1,1,2
2023/4/27 5:10,1,18,1,0,0,0,0
2023/4/27 5:20,1,18,1,0,2,2,4
2023/4/27 5:30,1,18,1,0,3,1,4
2023/4/27 5:40,1,19,1,0,2,1,3
2023/4/27 5:50,1,19,1,0,3,1,4
2023/4/27 6:00,1,19,1,0,3,3,6
2023/4/27 6:10,1,19,1,0,4,1,5
2023/4/27 6:20,1,19,1,0,5,1,6
2023/4/27 6:30,1,19,1,0,4,4,8
2023/4/27 6:40,1,19,1,0,13,0,13
2023/4/27 6:50,1,19,1,0,38,0,38
2023/4/27 7:00,1,19,1,0,65,4,69
2023/4/27 7:10,1,19,1,0,95,0,95
2023/4/27 7:20,1,19,1,0,96,2,98
2023/4/27 7:30,1,19,1,0,293,0,293
2023/4/27 7:40,1,20,1,0,506,5,511
2023/4/27 7:50,1,20,1,0,548,6,554
2023/4/27 8:00,1,20,1,0,313,6,319
2023/4/27 8:10,1,20,1,0,155,8,163
2023/4/27 8:20,1,20,1,0,90,11,101
2023/4/27 8:30,1,20,1,0,90,11,101
2023/4/27 8:40,1,20,1,0,77,13,90
2023/4/27 8:50,1,20,1,0,72,11,83
2023/4/27 9:00,1,20,1,0,90,17,107
2023/4/27 9:10,1,20,1,0,96,20,116
2023/4/27 9:20,1,20,1,0,155,30,185
2023/4/27 9:30,1,20,1,0,222,40,262
2023/4/27 9:40,1,20,1,0,230,135,365
2023/4/27 9:50,1,20,1,0,187,153,340
2023/4/27 10:00,1,21,1,0,132,151,283
2023/4/27 10:10,1,21,1,0,75,104,179
2023/4/27 10:20,1,21,1,0,82,78,160
2023/4/27 10:30,1,21,1,0,55,56,111
2023/4/27 10:40,1,21,1,0,67,40,107
2023/4/27 10:50,1,21,1,0,72,45,117
2023/4/27 11:00,1,21,1,0,66,39,105
2023/4/27 11:10,1,21,1,0,64,35,99
2023/4/27 11:20,1,21,1,0,56,48,104
2023/4/27 11:30,1,21,1,0,68,62,130
2023/4/27 11:40,1,21,1,0,73,241,314
2023/4/27 11:50,1,21,1,0,62,251,313
2023/4/27 12:00,1,21,1,0,63,253,316
2023/4/27 12:10,1,21,1,0,51,168,219
2023/4/27 12:20,1,21,1,0,62,117,179
2023/4/27 12:30,1,21,1,0,55,85,140
2023/4/27 12:40,1,21,1,0,59,67,126
2023/4/27 12:50,1,21,1,0,52,45,97
2023/4/27 13:00,1,21,1,0,55,29,84
2023/4/27 13:10,1,21,1,0,70,32,102
2023/4/27 13:20,1,21,1,0,77,34,111
2023/4/27 13:30,1,21,1,0,180,33,213
2023/4/27 13:40,1,21,1,0,224,37,261
2023/4/27 13:50,1,21,1,0,233,41,274
2023/4/27 14:00,1,21,1,0,131,28,159
2023/4/27 14:10,1,21,1,0,108,45,153
2023/4/27 14:20,1,21,1,0,107,40,147
2023/4/27 14:30,1,21,1,0,95,46,141
2023/4/27 14:40,1,21,1,0,88,47,135
2023/4/27 14:50,1,21,1,0,73,38,111
2023/4/27 15:00,1,21,1,0,72,45,117
2023/4/27 15:10,1,21,1,0,65,40,105
2023/4/27 15:20,1,20,1,0,68,43,111
2023/4/27 15:30,1,20,1,0,86,71,157
2023/4/27 15:40,1,20,1,0,136,172,308
2023/4/27 15:50,1,20,1,0,149,222,371
2023/4/27 16:00,1,19,1,0,99,156,255
2023/4/27 16:10,1,19,1,0,86,109,195
2023/4/27 16:20,1,19,1,0,79,90,169
2023/4/27 16:30,1,19,1,0,69,76,145
2023/4/27 16:40,1,19,1,0,71,59,130
2023/4/27 16:50,1,19,1,0,83,57,140
2023/4/27 17:00,1,19,1,0,70,65,135
2023/4/27 17:10,1,19,1,0,67,55,122
2023/4/27 17:20,1,19,1,0,88,58,146
2023/4/27 17:30,1,19,1,0,91,73,164
2023/4/27 17:40,1,19,1,0,90,240,330
2023/4/27 17:50,1,19,1,0,91,253,344
2023/4/27 18:00,1,19,1,0,104,205,309
2023/4/27 18:10,1,19,1,0,91,147,238
2023/4/27 18:20,1,19,1,0,102,97,199
2023/4/27 18:30,1,19,1,0,110,98,208
2023/4/27 18:40,1,19,1,0,202,72,274
2023/4/27 18:50,1,18,1,0,183,77,260
2023/4/27 19:00,1,18,1,0,124,58,182
2023/4/27 19:10,1,18,1,0,105,62,167
2023/4/27 19:20,1,18,1,0,87,63,150
2023/4/27 19:30,1,18,1,0,80,67,147
2023/4/27 19:40,1,18,1,0,85,55,140
2023/4/27 19:50,1,18,1,0,85,72,157
2023/4/27 20:00,1,18,1,0,74,71,145
2023/4/27 20:10,1,18,1,0,91,65,156
2023/4/27 20:20,1,18,1,0,81,60,141
2023/4/27 20:30,1,18,1,0,64,95,159
2023/4/27 20:40,1,18,1,0,62,177,239
2023/4/27 20:50,1,17,1,0,62,216,278
2023/4/27 21:00,1,17,1,0,51,147,198
2023/4/27 21:10,1,17,1,0,51,129,180
2023/4/27 21:20,1,17,1,0,31,106,137
2023/4/27 21:30,1,17,1,0,21,64,85
2023/4/27 21:40,1,17,1,0,21,67,88
2023/4/27 21:50,1,17,1,0,20,76,96
2023/4/27 22:00,1,17,1,0,14,79,93
2023/4/27 22:10,1,17,1,0,15,69,84
2023/4/27 22:20,1,17,1,0,18,42,60
2023/4/27 22:30,1,17,1,0,13,31,44
2023/4/27 22:40,1,17,1,0,12,19,31
2023/4/27 22:50,1,17,1,0,10,14,24
2023/4/27 23:00,1,17,1,0,11,12,23
2023/4/27 23:10,1,17,1,0,8,12,20
2023/4/27 23:20,1,17,1,0,6,9,15
2023/4/27 23:30,1,17,1,0,3,9,12
2023/4/27 23:40,1,17,1,0,2,10,12
2023/4/27 23:50,1,16,1,0,1,5,6
2023/4/28 0:00,1,16,1,0,4,0,4
2023/4/28 0:10,1,16,1,0,2,2,4
2023/4/28 0:20,1,16,1,0,3,2,5
2023/4/28 0:30,1,16,1,0,1,0,1
2023/4/28 0:40,1,16,1,0,1,0,1
2023/4/28 0:50,1,16,1,0,0,2,2
2023/4/28 1:00,1,16,1,0,2,2,4
2023/4/28 1:10,1,16,1,0,2,2,4
2023/4/28 1:20,1,16,1,0,1,0,1
2023/4/28 1:30,1,16,1,0,2,1,3
2023/4/28 1:40,1,16,1,0,1,0,1
2023/4/28 1:50,1,16,1,0,2,1,3
2023/4/28 2:00,1,16,1,0,2,2,4
2023/4/28 2:10,1,16,1,0,0,2,2
2023/4/28 2:20,1,15,1,0,0,0,0
2023/4/28 2:30,1,15,1,0,0,2,2
2023/4/28 2:40,1,15,1,0,1,2,3
2023/4/28 2:50,1,15,1,0,1,2,3
2023/4/28 3:00,1,15,1,0,2,2,4
2023/4/28 3:10,1,15,1,0,1,0,1
2023/4/28 3:20,1,15,1,0,2,0,2
2023/4/28 3:30,1,15,1,0,2,2,4
2023/4/28 3:40,1,15,1,0,0,0,0
2023/4/28 3:50,1,15,1,0,1,2,3
2023/4/28 4:00,1,15,1,0,2,1,3
2023/4/28 4:10,1,15,1,0,1,0,1
2023/4/28 4:20,1,15,1,0,0,1,1
2023/4/28 4:30,1,15,1,0,1,1,2
2023/4/28 4:40,1,15,1,0,0,1,1
2023/4/28 4:50,1,15,1,0,1,0,1
2023/4/28 5:00,1,15,1,0,1,2,3
2023/4/28 5:10,1,15,1,0,0,0,0
2023/4/28 5:20,1,15,1,0,2,1,3
2023/4/28 5:30,1,15,1,0,1,1,2
2023/4/28 5:40,1,16,1,0,2,2,4
2023/4/28 5:50,1,16,1,0,3,1,4
2023/4/28 6:00,1,16,1,0,3,2,5
2023/4/28 6:10,1,16,1,0,3,3,6
2023/4/28 6:20,1,16,1,0,6,3,9
2023/4/28 6:30,1,16,1,0,7,2,9
2023/4/28 6:40,1,16,1,0,12,0,12
2023/4/28 6:50,1,16,1,0,39,2,41
2023/4/28 7:00,1,16,1,0,54,4,58
2023/4/28 7:10,1,16,1,0,87,1,88
2023/4/28 7:20,1,17,1,0,104,3,107
2023/4/28 7:30,1,17,1,0,310,0,310
2023/4/28 7:40,1,17,1,0,493,4,497
2023/4/28 7:50,1,17,1,0,661,6,667
2023/4/28 8:00,1,17,1,0,325,7,332
2023/4/28 8:10,1,18,1,0,133,10,143
2023/4/28 8:20,1,18,1,0,102,11,113
2023/4/28 8:30,1,18,1,0,89,11,100
2023/4/28 8:40,1,18,1,0,86,15,101
2023/4/28 8:50,1,18,1,0,78,10,88
2023/4/28 9:00,1,18,1,0,78,13,91
2023/4/28 9:10,1,18,1,0,88,20,108
2023/4/28 9:20,1,18,1,0,136,32,168
2023/4/28 9:30,1,18,1,0,217,40,257
2023/4/28 9:40,1,18,1,0,239,145,384
2023/4/28 9:50,1,19,1,0,205,194,399
2023/4/28 10:00,1,19,1,0,149,136,285
2023/4/28 10:10,1,19,1,0,87,88,175
2023/4/28 10:20,1,19,1,0,81,66,147
2023/4/28 10:30,1,19,1,0,56,53,109
2023/4/28 10:40,1,19,1,0,55,42,97
2023/4/28 10:50,1,20,1,0,73,36,109
2023/4/28 11:00,1,20,1,0,75,37,112
2023/4/28 11:10,1,20,1,0,59,41,100
2023/4/28 11:20,1,20,1,0,57,49,106
2023/4/28 11:30,1,20,1,0,77,73,150
2023/4/28 11:40,1,20,1,0,74,228,302
2023/4/28 11:50,1,20,1,0,61,298,359
2023/4/28 12:00,1,20,1,0,53,247,300
2023/4/28 12:10,1,20,1,0,59,194,253
2023/4/28 12:20,1,20,1,0,66,136,202
2023/4/28 12:30,1,20,1,0,55,84,139
2023/4/28 12:40,1,20,1,0,54,74,128
2023/4/28 12:50,1,20,1,0,55,55,110
2023/4/28 13:00,1,20,1,0,65,29,94
2023/4/28 13:10,1,20,1,0,60,35,95
2023/4/28 13:20,1,20,1,0,76,36,112
2023/4/28 13:30,1,20,1,0,164,38,202
2023/4/28 13:40,1,20,1,0,263,35,298
2023/4/28 13:50,1,20,1,0,273,41,314
2023/4/28 14:00,1,19,1,0,131,34,165
2023/4/28 14:10,1,19,1,0,113,37,150
2023/4/28 14:20,1,19,1,0,110,38,148
2023/4/28 14:30,1,19,1,0,91,43,134
2023/4/28 14:40,1,19,1,0,84,44,128
2023/4/28 14:50,0,19,1,0,13,9,22
2023/4/28 15:00,0,18,1,0,14,9,23
2023/4/28 15:10,0,18,1,0,16,8,24
2023/4/28 15:20,0,18,1,0,16,8,24
2023/4/28 15:30,0,18,1,0,18,12,30
2023/4/28 15:40,0,18,1,0,27,34,61
2023/4/28 15:50,0,18,1,0,34,43,77
2023/4/28 16:00,0,18,1,0,18,27,45
2023/4/28 16:10,0,18,1,0,20,25,45
2023/4/28 16:20,0,18,1,0,13,16,29
2023/4/28 16:30,0,18,1,0,16,12,28
2023/4/28 16:40,0,18,1,0,14,11,25
2023/4/28 16:50,0,17,1,0,13,13,26
2023/4/28 17:00,0,17,1,0,17,12,29
2023/4/28 17:10,0,17,1,0,13,10,23
2023/4/28 17:20,0,17,1,0,15,12,27
2023/4/28 17:30,0,16,1,0,16,18,34
2023/4/28 17:40,0,16,1,0,18,53,71
2023/4/28 17:50,0,16,1,0,19,55,74
2023/4/28 18:00,0,15,1,0,20,44,64
2023/4/28 18:10,0,15,1,0,18,30,48
2023/4/28 18:20,0,15,1,0,19,19,38
2023/4/28 18:30,0,15,1,0,22,16,38
2023/4/28 18:40,0,15,1,0,36,15,51
2023/4/28 18:50,0,15,1,0,31,14,45
2023/4/28 19:00,0,15,1,0,29,13,42
2023/4/28 19:10,0,15,1,0,26,13,39
2023/4/28 19:20,0,14,1,0,21,14,35
2023/4/28 19:30,0,14,1,0,19,11,30
2023/4/28 19:40,0,14,1,0,16,13,29
2023/4/28 19:50,0,14,1,0,17,13,30
2023/4/28 20:00,0,14,1,0,16,14,30
2023/4/28 20:10,0,14,1,0,17,12,29
2023/4/28 20:20,0,14,1,0,15,13,28
2023/4/28 20:30,0,14,1,0,13,20,33
2023/4/28 20:40,0,14,1,0,14,39,53
2023/4/28 20:50,0,14,1,0,10,43,53
2023/4/28 21:00,0,14,1,0,11,30,41
2023/4/28 21:10,0,13,1,0,9,28,37
2023/4/28 21:20,0,13,1,0,7,19,26
2023/4/28 21:30,0,13,1,0,5,14,19
2023/4/28 21:40,0,13,1,0,4,15,19
2023/4/28 21:50,0,13,1,0,4,17,21
2023/4/28 22:00,0,13,1,0,3,16,19
2023/4/28 22:10,0,13,1,0,3,13,16
2023/4/28 22:20,0,13,1,0,3,9,12
2023/4/28 22:30,0,13,1,0,3,7,10
2023/4/28 22:40,0,13,1,0,2,4,6
2023/4/28 22:50,0,13,1,0,2,3,5
2023/4/28 23:00,0,13,1,0,2,3,5
2023/4/28 23:10,0,12,1,0,1,2,3
2023/4/28 23:20,0,12,1,0,1,2,3
2023/4/28 23:30,0,12,1,0,0,2,2
2023/4/28 23:40,0,12,1,0,1,2,3
2023/4/28 23:50,0,12,1,0,0,1,1
2023/4/29 0:00,0,12,0,0,0,0,0
2023/4/29 0:10,0,12,0,0,0,0,0
2023/4/29 0:20,0,12,0,0,0,0,0
2023/4/29 0:30,0,11,0,0,0,0,0
2023/4/29 0:40,0,11,0,0,0,0,0
2023/4/29 0:50,0,11,0,0,0,0,0
2023/4/29 1:00,0,11,0,0,0,0,0
2023/4/29 1:10,0,11,0,0,0,0,0
2023/4/29 1:20,0,11,0,0,0,0,0
2023/4/29 1:30,0,11,0,0,0,0,0
2023/4/29 1:40,0,11,0,0,0,0,0
2023/4/29 1:50,1,11,0,0,0,2,2
2023/4/29 2:00,1,10,0,0,1,1,2
2023/4/29 2:10,1,10,0,0,1,1,2
2023/4/29 2:20,1,10,0,0,2,0,2
2023/4/29 2:30,1,10,0,0,0,0,0
2023/4/29 2:40,1,10,0,0,1,2,3
2023/4/29 2:50,1,10,0,0,0,0,0
2023/4/29 3:00,1,10,0,0,1,2,3
2023/4/29 3:10,1,10,0,0,0,2,2
2023/4/29 3:20,1,10,0,0,2,2,4
2023/4/29 3:30,1,10,0,0,2,1,3
2023/4/29 3:40,1,10,0,0,2,0,2
2023/4/29 3:50,1,10,0,0,1,2,3
2023/4/29 4:00,1,10,0,0,2,1,3
2023/4/29 4:10,1,10,0,0,0,0,0
2023/4/29 4:20,1,10,0,0,2,1,3
2023/4/29 4:30,1,10,0,0,0,2,2
2023/4/29 4:40,1,11,0,0,0,1,1
2023/4/29 4:50,1,11,0,0,1,1,2
2023/4/29 5:00,1,11,0,0,0,2,2
2023/4/29 5:10,1,11,0,0,1,1,2
2023/4/29 5:20,1,11,0,0,3,2,5
2023/4/29 5:30,1,11,0,0,1,1,2
2023/4/29 5:40,1,11,0,0,1,2,3
2023/4/29 5:50,1,11,0,0,4,2,6
2023/4/29 6:00,1,12,0,0,6,1,7
2023/4/29 6:10,1,12,0,0,9,0,9
2023/4/29 6:20,1,12,0,0,8,0,8
2023/4/29 6:30,1,12,0,0,11,3,14
2023/4/29 6:40,1,12,0,0,12,1,13
2023/4/29 6:50,1,12,0,0,8,3,11
2023/4/29 7:00,1,12,0,0,14,0,14
2023/4/29 7:10,1,13,0,0,21,2,23
2023/4/29 7:20,1,13,0,0,41,2,43
2023/4/29 7:30,1,14,0,0,49,4,53
2023/4/29 7:40,1,14,0,0,62,4,66
2023/4/29 7:50,1,14,0,0,60,2,62
2023/4/29 8:00,1,14,0,0,38,5,43
2023/4/29 8:10,1,14,0,0,43,2,45
2023/4/29 8:20,1,14,0,0,33,0,33
2023/4/29 8:30,1,15,0,0,33,3,36
2023/4/29 8:40,1,15,0,0,25,5,30
2023/4/29 8:50,1,15,0,0,34,5,39
2023/4/29 9:00,1,15,0,0,32,3,35
2023/4/29 9:10,1,15,0,0,36,6,42
2023/4/29 9:20,1,16,0,0,29,6,35
2023/4/29 9:30,1,16,0,0,32,16,48
2023/4/29 9:40,1,16,0,0,36,16,52
2023/4/29 9:50,1,16,0,0,44,12,56
2023/4/29 10:00,1,16,0,0,33,19,52
2023/4/29 10:10,1,17,0,0,26,13,39
2023/4/29 10:20,1,17,0,0,19,8,27
2023/4/29 10:30,1,17,0,0,20,14,34
2023/4/29 10:40,1,17,0,0,23,16,39
2023/4/29 10:50,1,17,0,0,20,15,35
2023/4/29 11:00,1,18,0,0,15,21,36
2023/4/29 11:10,1,18,0,0,17,15,32
2023/4/29 11:20,1,18,0,0,12,17,29
2023/4/29 11:30,1,18,0,0,17,24,41
2023/4/29 11:40,1,18,0,0,13,22,35
2023/4/29 11:50,1,18,0,0,14,28,42
2023/4/29 12:00,1,18,0,0,10,37,47
2023/4/29 12:10,1,18,0,0,13,26,39
2023/4/29 12:20,1,19,0,0,10,27,37
2023/4/29 12:30,1,19,0,0,14,31,45
2023/4/29 12:40,1,19,0,0,12,35,47
2023/4/29 12:50,1,19,0,0,11,29,40
2023/4/29 13:00,1,20,0,0,9,21,30
2023/4/29 13:10,1,20,0,0,14,16,30
2023/4/29 13:20,1,21,0,0,14,15,29
2023/4/29 13:30,1,21,0,0,16,14,30
2023/4/29 13:40,1,21,0,0,28,19,47
2023/4/29 13:50,1,21,0,0,22,19,41
2023/4/29 14:00,1,21,0,0,26,21,47
2023/4/29 14:10,1,22,0,0,16,22,38
2023/4/29 14:20,1,22,0,0,15,16,31
2023/4/29 14:30,1,22,0,0,17,15,32
2023/4/29 14:40,1,22,0,0,17,15,32
2023/4/29 14:50,1,22,0,0,20,14,34
2023/4/29 15:00,1,23,0,0,21,11,32
2023/4/29 15:10,1,23,0,0,26,15,41
2023/4/29 15:20,1,23,0,0,24,15,39
2023/4/29 15:30,1,23,0,0,25,17,42
2023/4/29 15:40,1,23,0,0,20,16,36
2023/4/29 15:50,1,23,0,0,29,16,45
2023/4/29 16:00,1,23,0,0,26,17,43
2023/4/29 16:10,1,23,0,0,27,16,43
2023/4/29 16:20,1,23,0,0,29,14,43
2023/4/29 16:30,1,23,0,0,26,10,36
2023/4/29 16:40,1,23,0,0,25,12,37
2023/4/29 16:50,1,23,0,0,35,14,49
2023/4/29 17:00,1,22,0,0,39,20,59
2023/4/29 17:10,1,22,0,0,34,19,53
2023/4/29 17:20,1,22,0,0,40,24,64
2023/4/29 17:30,1,22,0,0,37,22,59
2023/4/29 17:40,1,22,0,0,38,30,68
2023/4/29 17:50,1,22,0,0,35,30,65
2023/4/29 18:00,1,21,0,0,48,37,85
2023/4/29 18:10,1,21,0,0,41,29,70
2023/4/29 18:20,1,21,0,0,47,26,73
2023/4/29 18:30,1,21,0,0,36,27,63
2023/4/29 18:40,1,21,0,0,36,27,63
2023/4/29 18:50,1,21,0,0,36,27,63
2023/4/29 19:00,1,21,0,0,33,20,53
2023/4/29 19:10,1,20,0,0,26,23,49
2023/4/29 19:20,1,20,0,0,27,17,44
2023/4/29 19:30,1,20,0,0,23,20,43
2023/4/29 19:40,1,20,0,0,22,19,41
2023/4/29 19:50,1,20,0,0,22,16,38
2023/4/29 20:00,1,20,0,0,21,19,40
2023/4/29 20:10,1,20,0,0,15,22,37
2023/4/29 20:20,1,20,0,0,17,23,40
2023/4/29 20:30,1,20,0,0,15,28,43
2023/4/29 20:40,1,19,0,0,17,31,48
2023/4/29 20:50,1,19,0,0,17,28,45
2023/4/29 21:00,1,19,0,0,11,38,49
2023/4/29 21:10,1,19,0,0,13,27,40
2023/4/29 21:20,1,18,0,0,11,27,38
2023/4/29 21:30,1,18,0,0,9,25,34
2023/4/29 21:40,1,18,0,0,6,38,44
2023/4/29 21:50,1,18,0,0,7,43,50
2023/4/29 22:00,1,18,0,0,5,36,41
2023/4/29 22:10,1,18,0,0,5,31,36
2023/4/29 22:20,1,18,0,0,2,26,28
2023/4/29 22:30,1,18,0,0,1,20,21
2023/4/29 22:40,1,18,0,0,2,14,16
2023/4/29 22:50,1,17,0,0,4,11,15
2023/4/29 23:00,1,17,0,0,1,6,7
2023/4/29 23:10,1,17,0,0,2,5,7
2023/4/29 23:20,1,16,0,0,2,2,4
2023/4/29 23:30,1,16,0,0,1,0,1
2023/4/29 23:40,1,16,0,0,2,1,3
2023/4/29 23:50,1,15,0,0,2,1,3
2023/4/30 0:00,1,15,0,0,1,2,3
2023/4/30 0:10,1,15,0,0,2,1,3
2023/4/30 0:20,1,15,0,0,0,1,1
2023/4/30 0:30,1,14,0,0,2,2,4
2023/4/30 0:40,1,14,0,0,0,2,2
2023/4/30 0:50,1,14,0,0,1,2,3
2023/4/30 1:00,1,14,0,0,2,2,4
2023/4/30 1:10,1,14,0,0,2,2,4
2023/4/30 1:20,1,13,0,0,1,0,1
2023/4/30 1:30,1,13,0,0,0,2,2
2023/4/30 1:40,1,12,0,0,1,1,2
2023/4/30 1:50,1,12,0,0,2,1,3
2023/4/30 2:00,1,12,0,0,1,2,3
2023/4/30 2:10,1,12,0,0,0,2,2
2023/4/30 2:20,1,12,0,0,1,2,3
2023/4/30 2:30,1,12,0,0,1,0,1
2023/4/30 2:40,1,12,0,0,1,1,2
2023/4/30 2:50,1,12,0,0,2,0,2
2023/4/30 3:00,1,11,0,0,1,2,3
2023/4/30 3:10,1,11,0,0,0,1,1
2023/4/30 3:20,1,11,0,0,0,2,2
2023/4/30 3:30,1,11,0,0,0,0,0
2023/4/30 3:40,1,11,0,0,0,1,1
2023/4/30 3:50,1,11,0,0,1,2,3
2023/4/30 4:00,1,11,0,0,0,1,1
2023/4/30 4:10,1,11,0,0,0,2,2
2023/4/30 4:20,1,12,0,0,2,2,4
2023/4/30 4:30,1,12,0,0,0,1,1
2023/4/30 4:40,1,13,0,0,0,2,2
2023/4/30 4:50,1,13,0,0,1,0,1
2023/4/30 5:00,1,13,0,0,0,2,2
2023/4/30 5:10,1,13,0,0,2,2,4
2023/4/30 5:20,1,13,0,0,3,2,5
2023/4/30 5:30,1,13,0,0,1,0,1
2023/4/30 5:40,1,14,0,0,3,0,3
2023/4/30 5:50,1,14,0,0,3,0,3
2023/4/30 6:00,1,14,0,0,6,0,6
2023/4/30 6:10,1,14,0,0,6,2,8
2023/4/30 6:20,1,14,0,0,8,2,10
2023/4/30 6:30,1,15,0,0,9,3,12
2023/4/30 6:40,1,15,0,0,9,2,11
2023/4/30 6:50,1,15,0,0,11,3,14
2023/4/30 7:00,1,16,0,0,13,2,15
2023/4/30 7:10,1,16,0,0,20,2,22
2023/4/30 7:20,1,16,0,0,45,2,47
2023/4/30 7:30,1,17,0,0,55,3,58
2023/4/30 7:40,1,17,0,0,52,2,54
2023/4/30 7:50,1,17,0,0,52,3,55
2023/4/30 8:00,1,17,0,0,38,6,44
2023/4/30 8:10,1,18,0,0,44,2,46
2023/4/30 8:20,1,18,0,0,32,1,33
2023/4/30 8:30,1,18,0,0,36,2,38
2023/4/30 8:40,1,18,0,0,27,3,30
2023/4/30 8:50,1,18,0,0,34,5,39
2023/4/30 9:00,1,18,0,0,27,3,30
2023/4/30 9:10,1,18,0,0,33,4,37
2023/4/30 9:20,1,19,0,0,29,7,36
2023/4/30 9:30,1,19,0,0,38,15,53
2023/4/30 9:40,1,19,0,0,35,18,53
2023/4/30 9:50,1,19,0,0,37,10,47
2023/4/30 10:00,1,19,0,0,34,14,48
2023/4/30 10:10,1,19,0,0,23,9,32
2023/4/30 10:20,1,20,0,0,20,8,28
2023/4/30 10:30,1,20,0,0,22,14,36
2023/4/30 10:40,1,20,0,0,22,17,39
2023/4/30 10:50,1,20,0,0,19,19,38
2023/4/30 11:00,1,21,0,0,13,17,30
2023/4/30 11:10,1,21,0,0,19,16,35
2023/4/30 11:20,1,22,0,0,10,22,32
2023/4/30 11:30,1,22,0,0,14,24,38
2023/4/30 11:40,1,23,0,0,11,24,35
2023/4/30 11:50,1,23,0,0,14,30,44
2023/4/30 12:00,1,23,0,0,12,35,47
2023/4/30 12:10,1,24,0,0,15,27,42
2023/4/30 12:20,1,24,0,0,10,26,36
2023/4/30 12:30,1,24,0,0,16,31,47
2023/4/30 12:40,1,24,0,0,11,33,44
2023/4/30 12:50,1,24,0,0,9,25,34
2023/4/30 13:00,1,24,0,0,12,24,36
2023/4/30 13:10,1,24,0,0,10,20,30
2023/4/30 13:20,1,25,0,0,16,18,34
2023/4/30 13:30,1,25,0,0,14,16,30
2023/4/30 13:40,1,25,0,0,27,19,46
2023/4/30 13:50,1,25,0,0,24,17,41
2023/4/30 14:00,1,25,0,0,22,21,43
2023/4/30 14:10,1,26,0,0,19,19,38
2023/4/30 14:20,1,26,0,0,16,17,33
2023/4/30 14:30,1,26,0,0,13,19,32
2023/4/30 14:40,1,26,0,0,15,13,28
2023/4/30 14:50,1,26,0,0,18,14,32
2023/4/30 15:00,1,26,0,0,21,13,34
2023/4/30 15:10,1,27,0,0,23,12,35
2023/4/30 15:20,1,27,0,0,24,15,39
2023/4/30 15:30,1,27,0,0,23,17,40
2023/4/30 15:40,1,27,0,0,26,17,43
2023/4/30 15:50,1,27,0,0,28,17,45
2023/4/30 16:00,1,28,0,0,26,13,39
2023/4/30 16:10,1,28,0,0,25,17,42
2023/4/30 16:20,1,28,0,0,26,15,41
2023/4/30 16:30,1,28,0,0,29,10,39
2023/4/30 16:40,1,28,0,0,29,11,40
2023/4/30 16:50,1,28,0,0,34,16,50
2023/4/30 17:00,1,28,0,0,32,16,48
2023/4/30 17:10,1,28,0,0,33,18,51
2023/4/30 17:20,1,28,0,0,40,21,61
2023/4/30 17:30,1,28,0,0,36,23,59
2023/4/30 17:40,1,28,0,0,34,31,65
2023/4/30 17:50,1,28,0,0,36,31,67
2023/4/30 18:00,1,27,0,0,47,33,80
2023/4/30 18:10,1,27,0,0,42,34,76
2023/4/30 18:20,1,27,0,0,42,28,70
2023/4/30 18:30,1,27,0,0,41,28,69
2023/4/30 18:40,1,27,0,0,36,23,59
2023/4/30 18:50,1,27,0,0,38,29,67
2023/4/30 19:00,1,26,0,0,32,20,52
2023/4/30 19:10,1,26,0,0,32,22,54
2023/4/30 19:20,1,26,0,0,23,19,42
2023/4/30 19:30,1,26,0,0,26,16,42
2023/4/30 19:40,1,25,0,0,28,19,47
2023/4/30 19:50,1,25,0,0,24,19,43
2023/4/30 20:00,1,25,0,0,25,22,47
2023/4/30 20:10,1,25,0,0,17,23,40
2023/4/30 20:20,1,25,0,0,18,20,38
2023/4/30 20:30,1,25,0,0,19,29,48
2023/4/30 20:40,1,25,0,0,14,28,42
2023/4/30 20:50,1,25,0,0,17,30,47
2023/4/30 21:00,1,25,0,0,10,34,44
2023/4/30 21:10,1,24,0,0,16,28,44
2023/4/30 21:20,1,24,0,0,13,27,40
2023/4/30 21:30,1,24,0,0,9,22,31
2023/4/30 21:40,1,24,0,0,7,41,48
2023/4/30 21:50,1,23,0,0,7,37,44
2023/4/30 22:00,1,23,0,0,5,40,45
2023/4/30 22:10,1,23,0,0,5,30,35
2023/4/30 22:20,1,23,0,0,4,24,28
2023/4/30 22:30,1,23,0,0,2,18,20
2023/4/30 22:40,1,23,0,0,2,10,12
2023/4/30 22:50,1,22,0,0,4,10,14
2023/4/30 23:00,1,22,0,0,1,4,5
2023/4/30 23:10,1,22,0,0,2,3,5
2023/4/30 23:20,1,22,0,0,1,3,4
2023/4/30 23:30,1,22,0,0,2,0,2
2023/4/30 23:40,1,22,0,0,2,2,4
2023/4/30 23:50,1,22,0,0,2,1,3
